exposure	direction_group	outcome	group
AARSD1	negative	colon	Female
ACAN	negative	colon	Female
ACE2	negative	colon	Female
ACP5	positive	colon	Female
ACP6	NA	colon	Female
ACVRL1	negative	colon	Female
ACY1	negative	colon	Female
ADA2	negative	colon	Female
ADAM15	positive	colon	Female
ADAM22	negative	colon	Female
ADAMTS13	positive	colon	Female
ADAMTS8	negative	colon	Female
ADGRB3	negative	colon	Female
ADGRE5	negative	colon	Female
ADH4	positive	colon	Female
AFP	positive	colon	Female
AGR2	positive	colon	Female
AGR3	NA	colon	Female
AGRP	positive	colon	Female
AKT1S1	NA	colon	Female
ALDH1A1	negative	colon	Female
ALPP	negative	colon	Female
AMBP	negative	colon	Female
AMY2A	positive	colon	Female
AMY2B	positive	colon	Female
ANG	negative	colon	Female
ANGPT1	negative	colon	Female
ANGPTL2	negative	colon	Female
ANGPTL7	negative	colon	Female
ANPEP	negative	colon	Female
ANXA11	NA	colon	Female
ANXA3	positive	colon	Female
ANXA4	NA	colon	Female
AOC3	negative	colon	Female
APOM	negative	colon	Female
APP	negative	colon	Female
ARG1	negative	colon	Female
ARHGAP1	NA	colon	Female
ARHGAP25	NA	colon	Female
ARSB	negative	colon	Female
ART3	negative	colon	Female
ASAH2	negative	colon	Female
ATG4A	negative	colon	Female
ATP5IF1	positive	colon	Female
ATXN10	negative	colon	Female
AXL	negative	colon	Female
B4GAT1	negative	colon	Female
BACH1	NA	colon	Female
BAG3	positive	colon	Female
BANK1	NA	colon	Female
BAX	NA	colon	Female
BCAN	negative	colon	Female
BCL2L11	positive	colon	Female
BGN	positive	colon	Female
BID	NA	colon	Female
BIN2	NA	colon	Female
BIRC2	positive	colon	Female
BLMH	negative	colon	Female
BLVRB	NA	colon	Female
BMP4	negative	colon	Female
BMP6	negative	colon	Female
BRK1	positive	colon	Female
BSG	negative	colon	Female
BTC	negative	colon	Female
BTN2A1	positive	colon	Female
C1QA	positive	colon	Female
C1QTNF1	positive	colon	Female
C2	NA	colon	Female
C4BPB	negative	colon	Female
CA11	NA	colon	Female
CA14	NA	colon	Female
CA2	NA	colon	Female
CA3	negative	colon	Female
CA4	negative	colon	Female
CA5A	positive	colon	Female
CA6	positive	colon	Female
CALCA	positive	colon	Female
CALCOCO1	negative	colon	Female
CAMKK1	negative	colon	Female
CAPG	NA	colon	Female
CASP10	positive	colon	Female
CASP2	NA	colon	Female
CASP3	NA	colon	Female
CASP8	negative	colon	Female
CC2D1A	NA	colon	Female
CCL11	positive	colon	Female
CCL14	positive	colon	Female
CCL15	negative	colon	Female
CCL16	positive	colon	Female
CCL17	positive	colon	Female
CCL18	negative	colon	Female
CCL22	positive	colon	Female
CCL24	positive	colon	Female
CCL25	negative	colon	Female
CCL26	negative	colon	Female
CCL27	negative	colon	Female
CCL3	negative	colon	Female
CCN1	negative	colon	Female
CD14	negative	colon	Female
CD163	negative	colon	Female
CD177	negative	colon	Female
CD200R1	positive	colon	Female
CD207	positive	colon	Female
CD209	positive	colon	Female
CD244	negative	colon	Female
CD274	negative	colon	Female
CD300C	positive	colon	Female
CD300E	negative	colon	Female
CD33	positive	colon	Female
CD38	NA	colon	Female
CD40	negative	colon	Female
CD40LG	negative	colon	Female
CD46	negative	colon	Female
CD55	negative	colon	Female
CD63	negative	colon	Female
CD84	negative	colon	Female
CD99L2	negative	colon	Female
CDC27	NA	colon	Female
CDC37	NA	colon	Female
CDCP1	negative	colon	Female
CDH1	negative	colon	Female
CDH15	NA	colon	Female
CDH3	negative	colon	Female
CDH6	negative	colon	Female
CDHR1	positive	colon	Female
CDKN1A	negative	colon	Female
CDKN2D	positive	colon	Female
CDON	negative	colon	Female
CDSN	negative	colon	Female
CEACAM1	negative	colon	Female
CEACAM21	NA	colon	Female
CEACAM3	NA	colon	Female
CEP20	positive	colon	Female
CERT	positive	colon	Female
CES1	negative	colon	Female
CES2	NA	colon	Female
CES3	negative	colon	Female
CETN2	positive	colon	Female
CFC1	positive	colon	Female
CGREF1	negative	colon	Female
CHAC2	NA	colon	Female
CHGB	negative	colon	Female
CHI3L1	negative	colon	Female
CHIT1	negative	colon	Female
CHMP1A	positive	colon	Female
CHRDL1	negative	colon	Female
CHRDL2	negative	colon	Female
CKAP4	negative	colon	Female
CKMT1A_CKMT1B	negative	colon	Female
CLC	positive	colon	Female
CLEC14A	positive	colon	Female
CLEC1A	negative	colon	Female
CLEC1B	negative	colon	Female
CLEC4A	negative	colon	Female
CLEC4C	positive	colon	Female
CLEC5A	negative	colon	Female
CLIP2	NA	colon	Female
CLUL1	negative	colon	Female
CNDP1	negative	colon	Female
CNPY4	NA	colon	Female
CNST	negative	colon	Female
CNTN1	positive	colon	Female
CNTN2	positive	colon	Female
CNTN5	negative	colon	Female
CNTNAP2	negative	colon	Female
COL18A1	positive	colon	Female
COL9A1	positive	colon	Female
COLEC12	negative	colon	Female
COMP	negative	colon	Female
COMT	NA	colon	Female
CORO1A	positive	colon	Female
COX5B	negative	colon	Female
CPB1	positive	colon	Female
CPM	positive	colon	Female
CPVL	negative	colon	Female
CPXM1	negative	colon	Female
CRACR2A	positive	colon	Female
CREG1	negative	colon	Female
CRHBP	negative	colon	Female
CRIP2	positive	colon	Female
CRISP2	negative	colon	Female
CRNN	negative	colon	Female
CRTAC1	NA	colon	Female
CSF1	positive	colon	Female
CST6	negative	colon	Female
CST7	negative	colon	Female
CTF1	NA	colon	Female
CTRB1	positive	colon	Female
CTSB	positive	colon	Female
CTSD	positive	colon	Female
CTSO	negative	colon	Female
CTSV	positive	colon	Female
CXADR	negative	colon	Female
CXCL1	negative	colon	Female
CXCL10	negative	colon	Female
CXCL11	negative	colon	Female
CXCL13	positive	colon	Female
CXCL14	NA	colon	Female
CXCL16	negative	colon	Female
CXCL3	negative	colon	Female
CXCL5	negative	colon	Female
CXCL6	negative	colon	Female
CXCL8	positive	colon	Female
DAB2	NA	colon	Female
DAG1	negative	colon	Female
DAPP1	NA	colon	Female
DBI	negative	colon	Female
DCXR	positive	colon	Female
DDAH1	negative	colon	Female
DDC	positive	colon	Female
DEFB4A_DEFB4B	positive	colon	Female
DFFA	NA	colon	Female
DKK1	negative	colon	Female
DKKL1	negative	colon	Female
DLK1	negative	colon	Female
DNAJB1	positive	colon	Female
DNER	positive	colon	Female
DNMBP	positive	colon	Female
DOK2	negative	colon	Female
DPT	NA	colon	Female
DPY30	NA	colon	Female
DRAXIN	positive	colon	Female
DSC2	negative	colon	Female
DSG3	negative	colon	Female
DTX3	positive	colon	Female
DUSP3	NA	colon	Female
EBI3_IL27	negative	colon	Female
EDA2R	negative	colon	Female
EDAR	positive	colon	Female
EDIL3	NA	colon	Female
EFEMP1	negative	colon	Female
EFNA1	positive	colon	Female
EGF	negative	colon	Female
EGFL7	positive	colon	Female
EGFR	negative	colon	Female
EGLN1	negative	colon	Female
EIF4B	positive	colon	Female
EIF4G1	positive	colon	Female
ELOA	NA	colon	Female
ENO1	positive	colon	Female
ENPP2	negative	colon	Female
ENPP5	positive	colon	Female
ENPP7	negative	colon	Female
ENTPD2	NA	colon	Female
ENTPD5	negative	colon	Female
ENTPD6	positive	colon	Female
EPCAM	negative	colon	Female
EPHA1	positive	colon	Female
EPHA2	negative	colon	Female
EPHB6	positive	colon	Female
EPO	positive	colon	Female
EPS8L2	positive	colon	Female
ERBB2	negative	colon	Female
ERBB3	negative	colon	Female
ERBIN	NA	colon	Female
EREG	negative	colon	Female
ESAM	negative	colon	Female
F2R	positive	colon	Female
F3	negative	colon	Female
F7	positive	colon	Female
F9	NA	colon	Female
FABP1	NA	colon	Female
FABP2	positive	colon	Female
FABP5	NA	colon	Female
FABP6	NA	colon	Female
FADD	negative	colon	Female
FAM3B	positive	colon	Female
FASLG	negative	colon	Female
FBP1	negative	colon	Female
FCAR	positive	colon	Female
FCGR2B	positive	colon	Female
FCGR3B	negative	colon	Female
FCRL2	positive	colon	Female
FCRL3	positive	colon	Female
FCRL5	negative	colon	Female
FCRLB	negative	colon	Female
FETUB	positive	colon	Female
FGF19	negative	colon	Female
FGF23	positive	colon	Female
FGF5	NA	colon	Female
FHIT	NA	colon	Female
FKBP5	negative	colon	Female
FLT3	negative	colon	Female
FOLR2	negative	colon	Female
FRZB	NA	colon	Female
FSTL3	NA	colon	Female
FUCA1	positive	colon	Female
FUS	NA	colon	Female
FUT3_FUT5	negative	colon	Female
FUT8	negative	colon	Female
FXYD5	NA	colon	Female
FYB1	NA	colon	Female
GAL	positive	colon	Female
GALNT2	positive	colon	Female
GALNT7	positive	colon	Female
GAS6	negative	colon	Female
GFRA1	positive	colon	Female
GFRA2	negative	colon	Female
GGT5	negative	colon	Female
GKN1	negative	colon	Female
GLOD4	NA	colon	Female
GLRX	NA	colon	Female
GNE	positive	colon	Female
GNLY	negative	colon	Female
GOPC	NA	colon	Female
GP1BA	negative	colon	Female
GP6	negative	colon	Female
GPA33	negative	colon	Female
GPC1	negative	colon	Female
GPC5	negative	colon	Female
GRAP2	positive	colon	Female
GRN	negative	colon	Female
GSTA3	negative	colon	Female
GYS1	positive	colon	Female
GZMH	positive	colon	Female
HARS1	NA	colon	Female
HAVCR1	negative	colon	Female
HBEGF	negative	colon	Female
HBQ1	NA	colon	Female
HCLS1	positive	colon	Female
HDGF	NA	colon	Female
HEXIM1	positive	colon	Female
HGF	positive	colon	Female
HLA-DRA	positive	colon	Female
HLA-E	positive	colon	Female
HMOX2	negative	colon	Female
HS3ST3B1	negative	colon	Female
HSD11B1	negative	colon	Female
HSPA1A	NA	colon	Female
HSPB6	positive	colon	Female
HYAL1	negative	colon	Female
ICA1	NA	colon	Female
ICAM2	negative	colon	Female
ICAM3	negative	colon	Female
ICAM4	negative	colon	Female
ICAM5	positive	colon	Female
IDS	positive	colon	Female
IDUA	positive	colon	Female
IFNG	NA	colon	Female
IFNGR1	negative	colon	Female
IFNL1	negative	colon	Female
IFNLR1	NA	colon	Female
IGF2R	positive	colon	Female
IGFBP1	NA	colon	Female
IGFBP3	negative	colon	Female
IGFBP4	negative	colon	Female
IGFBP6	negative	colon	Female
IGFBPL1	NA	colon	Female
IGSF3	positive	colon	Female
IL10	positive	colon	Female
IL10RB	positive	colon	Female
IL13RA1	NA	colon	Female
IL15	positive	colon	Female
IL17C	NA	colon	Female
IL17D	NA	colon	Female
IL17RA	negative	colon	Female
IL17RB	positive	colon	Female
IL18BP	negative	colon	Female
IL18R1	negative	colon	Female
IL19	positive	colon	Female
IL1B	NA	colon	Female
IL1R1	negative	colon	Female
IL1RAP	negative	colon	Female
IL1RN	NA	colon	Female
IL22RA1	NA	colon	Female
IL3RA	negative	colon	Female
IL5RA	negative	colon	Female
IL6	negative	colon	Female
IL6ST	negative	colon	Female
IL7	negative	colon	Female
IL7R	negative	colon	Female
INHBC	negative	colon	Female
IPCEF1	NA	colon	Female
IRAG2	NA	colon	Female
ISM1	NA	colon	Female
ITGA5	negative	colon	Female
ITGA6	negative	colon	Female
ITGB1	negative	colon	Female
ITGB2	negative	colon	Female
ITGB6	negative	colon	Female
JCHAIN	positive	colon	Female
KAZALD1	negative	colon	Female
KDR	positive	colon	Female
KIFBP	NA	colon	Female
KIR3DL1	NA	colon	Female
KLB	negative	colon	Female
KLK1	positive	colon	Female
KLK12	negative	colon	Female
KLK13	positive	colon	Female
KLK14	positive	colon	Female
KLK6	NA	colon	Female
KLK8	positive	colon	Female
KLRB1	negative	colon	Female
KRT18	negative	colon	Female
KRT5	negative	colon	Female
KYAT1	negative	colon	Female
L1CAM	negative	colon	Female
LACTB2	negative	colon	Female
LAG3	negative	colon	Female
LAMA4	positive	colon	Female
LAMP2	NA	colon	Female
LAYN	negative	colon	Female
LBP	NA	colon	Female
LBR	positive	colon	Female
LEPR	negative	colon	Female
LGALS1	NA	colon	Female
LGALS3	positive	colon	Female
LGALS7_LGALS7B	negative	colon	Female
LGALS8	positive	colon	Female
LIFR	positive	colon	Female
LILRA2	negative	colon	Female
LILRA5	negative	colon	Female
LILRB4	NA	colon	Female
LILRB5	NA	colon	Female
LPO	positive	colon	Female
LRIG1	positive	colon	Female
LRP1	positive	colon	Female
LRP11	positive	colon	Female
LRPAP1	positive	colon	Female
LRRC25	negative	colon	Female
LRRN1	negative	colon	Female
LSP1	NA	colon	Female
LTA	negative	colon	Female
LTBP2	negative	colon	Female
LTBR	positive	colon	Female
LY6D	positive	colon	Female
LY9	negative	colon	Female
LY96	negative	colon	Female
LYPD3	positive	colon	Female
LYPD8	positive	colon	Female
MANF	positive	colon	Female
MAP2K6	NA	colon	Female
MAP4K5	NA	colon	Female
MARCO	negative	colon	Female
MASP1	positive	colon	Female
MATN3	positive	colon	Female
MAX	positive	colon	Female
MCAM	negative	colon	Female
MEGF10	negative	colon	Female
MEGF9	positive	colon	Female
MERTK	negative	colon	Female
METAP1D	NA	colon	Female
MFGE8	positive	colon	Female
MIA	positive	colon	Female
MILR1	positive	colon	Female
MITD1	NA	colon	Female
MME	negative	colon	Female
MMP1	negative	colon	Female
MMP10	NA	colon	Female
MMP12	NA	colon	Female
MMP3	negative	colon	Female
MMP7	negative	colon	Female
MMP8	NA	colon	Female
MMP9	positive	colon	Female
MPHOSPH8	NA	colon	Female
MPI	negative	colon	Female
MPIG6B	negative	colon	Female
MPO	negative	colon	Female
MSLN	positive	colon	Female
MSMB	negative	colon	Female
MSR1	positive	colon	Female
MSRA	NA	colon	Female
MSTN	positive	colon	Female
MUC16	NA	colon	Female
MZB1	negative	colon	Female
MZT1	NA	colon	Female
NAAA	positive	colon	Female
NADK	negative	colon	Female
NCAM2	positive	colon	Female
NCAN	positive	colon	Female
NCF2	positive	colon	Female
NCR1	negative	colon	Female
NCS1	negative	colon	Female
NECTIN2	positive	colon	Female
NECTIN4	positive	colon	Female
NEFL	NA	colon	Female
NELL1	negative	colon	Female
NFASC	positive	colon	Female
NFKBIE	NA	colon	Female
NID1	negative	colon	Female
NID2	positive	colon	Female
NME3	negative	colon	Female
NOMO1	negative	colon	Female
NOS3	NA	colon	Female
NOTCH1	negative	colon	Female
NPDC1	negative	colon	Female
NPPB	NA	colon	Female
NPPC	NA	colon	Female
NPTX1	positive	colon	Female
NPTXR	negative	colon	Female
NPY	negative	colon	Female
NRP2	positive	colon	Female
NSFL1C	NA	colon	Female
NT5E	negative	colon	Female
NTF3	negative	colon	Female
NTproBNP	negative	colon	Female
NUB1	positive	colon	Female
NUDC	NA	colon	Female
NUDT2	NA	colon	Female
NUDT5	NA	colon	Female
OBP2B	positive	colon	Female
ODAM	NA	colon	Female
OLR1	positive	colon	Female
OPTC	negative	colon	Female
OSM	positive	colon	Female
OSMR	negative	colon	Female
PAEP	negative	colon	Female
PAM	negative	colon	Female
PAPPA	positive	colon	Female
PARK7	negative	colon	Female
PARP1	NA	colon	Female
PCSK9	negative	colon	Female
PDCD5	NA	colon	Female
PDCD6	negative	colon	Female
PDGFA	negative	colon	Female
PDGFB	negative	colon	Female
PDGFC	negative	colon	Female
PDGFRA	negative	colon	Female
PEAR1	negative	colon	Female
PEBP1	NA	colon	Female
PGF	NA	colon	Female
PGLYRP1	positive	colon	Female
PI3	positive	colon	Female
PIGR	positive	colon	Female
PIK3IP1	positive	colon	Female
PILRA	positive	colon	Female
PILRB	positive	colon	Female
PKLR	positive	colon	Female
PLA2G10	negative	colon	Female
PLA2G1B	positive	colon	Female
PLA2G2A	negative	colon	Female
PLA2G4A	NA	colon	Female
PLIN3	NA	colon	Female
PLPBP	NA	colon	Female
PLTP	negative	colon	Female
PLXDC1	positive	colon	Female
PLXNB2	positive	colon	Female
PLXNB3	negative	colon	Female
PM20D1	positive	colon	Female
PMVK	negative	colon	Female
PNPT1	NA	colon	Female
PODXL	positive	colon	Female
PODXL2	positive	colon	Female
PON2	positive	colon	Female
PON3	negative	colon	Female
PPCDC	NA	colon	Female
PPIB	negative	colon	Female
PPP1R2	positive	colon	Female
PPP1R9B	NA	colon	Female
PPY	positive	colon	Female
PRCP	positive	colon	Female
PRDX1	NA	colon	Female
PRDX5	NA	colon	Female
PRL	positive	colon	Female
PROC	negative	colon	Female
PROK1	NA	colon	Female
PRSS2	positive	colon	Female
PRSS27	positive	colon	Female
PRTFDC1	negative	colon	Female
PRTG	positive	colon	Female
PRTN3	positive	colon	Female
PSIP1	positive	colon	Female
PSME1	NA	colon	Female
PSRC1	NA	colon	Female
PTGDS	NA	colon	Female
PTN	negative	colon	Female
PTPN1	NA	colon	Female
PTPN6	NA	colon	Female
PTPRM	positive	colon	Female
PTPRS	positive	colon	Female
PTX3	positive	colon	Female
PVALB	positive	colon	Female
PVR	NA	colon	Female
RAB6A	NA	colon	Female
RABGAP1L	NA	colon	Female
RAD23B	NA	colon	Female
RARRES2	negative	colon	Female
RBP5	negative	colon	Female
REG1A	negative	colon	Female
REG1B	negative	colon	Female
REG3A	negative	colon	Female
REG4	NA	colon	Female
REN	NA	colon	Female
RETN	negative	colon	Female
RGMA	positive	colon	Female
RNASE3	positive	colon	Female
RNASET2	positive	colon	Female
ROBO2	negative	colon	Female
RP2	NA	colon	Female
RTBDN	NA	colon	Female
RTN4R	negative	colon	Female
RWDD1	NA	colon	Female
S100A11	NA	colon	Female
S100A12	positive	colon	Female
S100A4	negative	colon	Female
SAMD9L	NA	colon	Female
SCAMP3	positive	colon	Female
SCARB2	positive	colon	Female
SCG3	negative	colon	Female
SCGB1A1	positive	colon	Female
SCGB3A2	negative	colon	Female
SCGN	negative	colon	Female
SCRN1	NA	colon	Female
SDC1	negative	colon	Female
SELE	positive	colon	Female
SELP	positive	colon	Female
SEMA4C	positive	colon	Female
SEMA4D	positive	colon	Female
SEMA7A	negative	colon	Female
SEPTIN9	NA	colon	Female
SERPINA11	positive	colon	Female
SERPINA12	positive	colon	Female
SERPINB1	positive	colon	Female
SERPINB8	NA	colon	Female
SERPINB9	NA	colon	Female
SERPINE1	negative	colon	Female
SESTD1	positive	colon	Female
SEZ6L	positive	colon	Female
SFRP1	negative	colon	Female
SFTPA2	negative	colon	Female
SH2B3	negative	colon	Female
SH2D1A	NA	colon	Female
SHMT1	positive	colon	Female
SIAE	negative	colon	Female
SIGLEC1	negative	colon	Female
SIGLEC10	negative	colon	Female
SIGLEC7	negative	colon	Female
SIRPA	negative	colon	Female
SIRPB1	negative	colon	Female
SIRT2	NA	colon	Female
SIT1	negative	colon	Female
SKAP1	negative	colon	Female
SLAMF1	negative	colon	Female
SLC39A14	NA	colon	Female
SLITRK6	positive	colon	Female
SMOC1	positive	colon	Female
SMPD1	positive	colon	Female
SNAP23	NA	colon	Female
SNX9	NA	colon	Female
SOD1	negative	colon	Female
SOD2	positive	colon	Female
SORT1	negative	colon	Female
SPARC	negative	colon	Female
SPARCL1	positive	colon	Female
SPINK4	negative	colon	Female
SPINK5	positive	colon	Female
SPINT1	negative	colon	Female
SPINT2	negative	colon	Female
SRP14	NA	colon	Female
SRPK2	positive	colon	Female
SSC4D	positive	colon	Female
SSC5D	negative	colon	Female
ST3GAL1	negative	colon	Female
STAMBP	positive	colon	Female
STAT5B	NA	colon	Female
STIP1	NA	colon	Female
STK24	NA	colon	Female
STX4	NA	colon	Female
STX8	negative	colon	Female
SULT2A1	positive	colon	Female
SUMF2	positive	colon	Female
SUSD1	negative	colon	Female
SUSD2	positive	colon	Female
TACC3	positive	colon	Female
TACSTD2	negative	colon	Female
TAFA5	NA	colon	Female
TARBP2	NA	colon	Female
TBC1D23	negative	colon	Female
TBC1D5	NA	colon	Female
TBCC	negative	colon	Female
TBL1X	negative	colon	Female
TCL1A	positive	colon	Female
TDGF1	NA	colon	Female
TDRKH	positive	colon	Female
TFF1	negative	colon	Female
TFF2	negative	colon	Female
TFF3	negative	colon	Female
TFPI	negative	colon	Female
TFRC	negative	colon	Female
TGFB1	negative	colon	Female
TGFBI	negative	colon	Female
TGFBR2	positive	colon	Female
TGFBR3	negative	colon	Female
TGM2	NA	colon	Female
THBD	negative	colon	Female
THBS2	negative	colon	Female
THPO	negative	colon	Female
THY1	positive	colon	Female
TIA1	NA	colon	Female
TIGAR	NA	colon	Female
TIMD4	negative	colon	Female
TIMP1	negative	colon	Female
TIMP3	positive	colon	Female
TINAGL1	positive	colon	Female
TLR3	negative	colon	Female
TMPRSS15	negative	colon	Female
TNC	positive	colon	Female
TNFRSF10A	positive	colon	Female
TNFRSF10C	negative	colon	Female
TNFRSF11A	negative	colon	Female
TNFRSF12A	NA	colon	Female
TNFRSF13B	positive	colon	Female
TNFRSF13C	positive	colon	Female
TNFRSF14	positive	colon	Female
TNFRSF19	positive	colon	Female
TNFSF10	negative	colon	Female
TNFSF13	negative	colon	Female
TNFSF14	negative	colon	Female
TNR	negative	colon	Female
TNXB	positive	colon	Female
TPMT	NA	colon	Female
TPSAB1	negative	colon	Female
TRAF2	positive	colon	Female
TREM2	positive	colon	Female
TREML2	negative	colon	Female
TSHB	positive	colon	Female
TXLNA	NA	colon	Female
TXNDC15	positive	colon	Female
TXNDC5	negative	colon	Female
TYMP	NA	colon	Female
UMOD	negative	colon	Female
USP8	positive	colon	Female
UXS1	negative	colon	Female
VAT1	positive	colon	Female
VCAM1	negative	colon	Female
VCAN	negative	colon	Female
VEGFC	negative	colon	Female
VEGFD	negative	colon	Female
VMO1	negative	colon	Female
VNN2	positive	colon	Female
VPS37A	NA	colon	Female
VSIG4	positive	colon	Female
VSIR	negative	colon	Female
VSTM1	NA	colon	Female
VSTM2L	NA	colon	Female
VTA1	positive	colon	Female
VWA1	negative	colon	Female
WAS	NA	colon	Female
WASF1	NA	colon	Female
WFIKKN1	negative	colon	Female
WFIKKN2	positive	colon	Female
WWP2	NA	colon	Female
XCL1	negative	colon	Female
YES1	NA	colon	Female
ZBTB16	positive	colon	Female
ZBTB17	NA	colon	Female
