exposure	direction_group	outcome	group
AARSD1	negative	distal	Female
ACE2	positive	distal	Female
ACP5	positive	distal	Female
ACP6	NA	distal	Female
ACVRL1	negative	distal	Female
ADAM15	positive	distal	Female
ADAMTS13	positive	distal	Female
ADAMTS8	negative	distal	Female
ADGRB3	negative	distal	Female
AFP	positive	distal	Female
AGR3	NA	distal	Female
AGRP	positive	distal	Female
AKT1S1	NA	distal	Female
ALCAM	negative	distal	Female
ALPP	positive	distal	Female
AMBP	negative	distal	Female
AMIGO2	negative	distal	Female
AMY2B	positive	distal	Female
ANG	positive	distal	Female
ANGPT1	positive	distal	Female
ANGPTL7	negative	distal	Female
ANPEP	negative	distal	Female
ANXA11	NA	distal	Female
ANXA4	NA	distal	Female
AOC3	negative	distal	Female
APLP1	negative	distal	Female
APOM	negative	distal	Female
APRT	positive	distal	Female
AREG	positive	distal	Female
ARG1	negative	distal	Female
ARHGAP1	NA	distal	Female
ARHGAP25	NA	distal	Female
ARSB	negative	distal	Female
ART3	negative	distal	Female
ASAH2	negative	distal	Female
ATG4A	negative	distal	Female
ATP5IF1	positive	distal	Female
ATXN10	negative	distal	Female
AXIN1	positive	distal	Female
AXL	negative	distal	Female
B4GALT1	positive	distal	Female
B4GAT1	negative	distal	Female
BACH1	NA	distal	Female
BAG3	positive	distal	Female
BANK1	NA	distal	Female
BAX	NA	distal	Female
BCAN	negative	distal	Female
BCL2L11	positive	distal	Female
BID	NA	distal	Female
BIN2	NA	distal	Female
BIRC2	positive	distal	Female
BLMH	negative	distal	Female
BLVRB	NA	distal	Female
BMP4	negative	distal	Female
BMP6	negative	distal	Female
BPIFB1	negative	distal	Female
BRK1	positive	distal	Female
BSG	negative	distal	Female
BST1	positive	distal	Female
BTC	negative	distal	Female
BTN2A1	positive	distal	Female
C1QA	positive	distal	Female
C1QTNF1	positive	distal	Female
C2	NA	distal	Female
C4BPB	negative	distal	Female
CA11	NA	distal	Female
CA13	positive	distal	Female
CA14	NA	distal	Female
CA2	NA	distal	Female
CA3	negative	distal	Female
CA5A	positive	distal	Female
CA9	positive	distal	Female
CALB1	negative	distal	Female
CALCA	positive	distal	Female
CAMKK1	negative	distal	Female
CAPG	NA	distal	Female
CASP2	NA	distal	Female
CASP3	NA	distal	Female
CASP8	negative	distal	Female
CBLIF	positive	distal	Female
CC2D1A	NA	distal	Female
CCL11	negative	distal	Female
CCL14	positive	distal	Female
CCL15	negative	distal	Female
CCL16	positive	distal	Female
CCL17	positive	distal	Female
CCL18	negative	distal	Female
CCL2	negative	distal	Female
CCL21	negative	distal	Female
CCL22	positive	distal	Female
CCL24	negative	distal	Female
CCL27	positive	distal	Female
CCL3	negative	distal	Female
CCL5	positive	distal	Female
CCL8	positive	distal	Female
CCN2	positive	distal	Female
CD163	negative	distal	Female
CD164	negative	distal	Female
CD177	negative	distal	Female
CD200	negative	distal	Female
CD207	negative	distal	Female
CD300C	positive	distal	Female
CD300E	negative	distal	Female
CD300LF	positive	distal	Female
CD300LG	negative	distal	Female
CD302	negative	distal	Female
CD33	negative	distal	Female
CD34	negative	distal	Female
CD38	NA	distal	Female
CD40	negative	distal	Female
CD40LG	positive	distal	Female
CD46	negative	distal	Female
CD48	negative	distal	Female
CD55	negative	distal	Female
CD58	negative	distal	Female
CD84	negative	distal	Female
CD99L2	negative	distal	Female
CDC27	NA	distal	Female
CDC37	NA	distal	Female
CDCP1	negative	distal	Female
CDH1	negative	distal	Female
CDH15	NA	distal	Female
CDH17	negative	distal	Female
CDH5	negative	distal	Female
CDH6	negative	distal	Female
CDHR1	positive	distal	Female
CDKN1A	negative	distal	Female
CDKN2D	positive	distal	Female
CDON	negative	distal	Female
CDSN	positive	distal	Female
CEACAM21	NA	distal	Female
CEACAM3	NA	distal	Female
CEACAM5	positive	distal	Female
CEACAM8	positive	distal	Female
CEBPB	positive	distal	Female
CEP20	positive	distal	Female
CERT	positive	distal	Female
CES1	negative	distal	Female
CES2	NA	distal	Female
CES3	negative	distal	Female
CETN2	positive	distal	Female
CGREF1	negative	distal	Female
CHAC2	NA	distal	Female
CHGB	negative	distal	Female
CHIT1	negative	distal	Female
CHMP1A	positive	distal	Female
CHRDL2	negative	distal	Female
CIAPIN1	positive	distal	Female
CKAP4	positive	distal	Female
CKMT1A_CKMT1B	negative	distal	Female
CLC	negative	distal	Female
CLEC11A	negative	distal	Female
CLEC14A	negative	distal	Female
CLEC4A	negative	distal	Female
CLEC4C	negative	distal	Female
CLEC4D	positive	distal	Female
CLEC7A	negative	distal	Female
CLIP2	NA	distal	Female
CLSTN2	positive	distal	Female
CLUL1	negative	distal	Female
CNDP1	negative	distal	Female
CNPY4	NA	distal	Female
CNTN2	positive	distal	Female
CNTN5	negative	distal	Female
COL18A1	positive	distal	Female
COL6A3	negative	distal	Female
COL9A1	positive	distal	Female
COLEC12	negative	distal	Female
COMP	negative	distal	Female
COMT	NA	distal	Female
CORO1A	positive	distal	Female
COX5B	negative	distal	Female
CPB1	positive	distal	Female
CPM	positive	distal	Female
CPVL	negative	distal	Female
CR2	positive	distal	Female
CRADD	negative	distal	Female
CREG1	negative	distal	Female
CRH	positive	distal	Female
CRIP2	positive	distal	Female
CRTAC1	NA	distal	Female
CSF1	positive	distal	Female
CST5	negative	distal	Female
CST6	negative	distal	Female
CST7	positive	distal	Female
CTF1	NA	distal	Female
CTRB1	negative	distal	Female
CTSB	positive	distal	Female
CTSC	negative	distal	Female
CTSD	positive	distal	Female
CTSO	negative	distal	Female
CTSS	negative	distal	Female
CTSV	positive	distal	Female
CTSZ	negative	distal	Female
CXADR	negative	distal	Female
CXCL1	positive	distal	Female
CXCL10	negative	distal	Female
CXCL13	positive	distal	Female
CXCL14	NA	distal	Female
CXCL17	positive	distal	Female
CXCL3	negative	distal	Female
CXCL5	negative	distal	Female
DAB2	NA	distal	Female
DAPP1	NA	distal	Female
DARS1	positive	distal	Female
DCBLD2	positive	distal	Female
DCXR	positive	distal	Female
DDAH1	positive	distal	Female
DDC	positive	distal	Female
DECR1	positive	distal	Female
DEFA1_DEFA1B	negative	distal	Female
DEFB4A_DEFB4B	positive	distal	Female
DFFA	NA	distal	Female
DKK1	positive	distal	Female
DKK4	positive	distal	Female
DKKL1	negative	distal	Female
DLK1	negative	distal	Female
DNAJB1	positive	distal	Female
DNER	positive	distal	Female
DOK2	positive	distal	Female
DPP4	positive	distal	Female
DPP6	positive	distal	Female
DPP7	negative	distal	Female
DPT	NA	distal	Female
DPY30	NA	distal	Female
DRAXIN	positive	distal	Female
DRG2	negative	distal	Female
DSG3	negative	distal	Female
DSG4	negative	distal	Female
DTX3	positive	distal	Female
DUSP3	NA	distal	Female
EBAG9	positive	distal	Female
EBI3_IL27	positive	distal	Female
EDIL3	NA	distal	Female
EFEMP1	negative	distal	Female
EFNA1	positive	distal	Female
EGF	positive	distal	Female
EGFR	negative	distal	Female
EGLN1	negative	distal	Female
EIF4B	positive	distal	Female
EIF4G1	positive	distal	Female
ELOA	NA	distal	Female
ENPP7	negative	distal	Female
ENTPD2	NA	distal	Female
ENTPD5	negative	distal	Female
ENTPD6	positive	distal	Female
EPCAM	negative	distal	Female
EPHB6	positive	distal	Female
EPO	positive	distal	Female
EPS8L2	positive	distal	Female
ERBIN	NA	distal	Female
ERP44	positive	distal	Female
F11R	positive	distal	Female
F3	negative	distal	Female
F7	positive	distal	Female
F9	NA	distal	Female
FABP1	NA	distal	Female
FABP5	NA	distal	Female
FABP6	NA	distal	Female
FABP9	negative	distal	Female
FADD	negative	distal	Female
FAM3B	positive	distal	Female
FAP	positive	distal	Female
FBP1	negative	distal	Female
FCAR	positive	distal	Female
FCGR3B	negative	distal	Female
FCRL1	positive	distal	Female
FCRL2	positive	distal	Female
FCRL3	positive	distal	Female
FCRL5	negative	distal	Female
FCRLB	negative	distal	Female
FETUB	positive	distal	Female
FGF19	negative	distal	Female
FGF2	positive	distal	Female
FGF21	negative	distal	Female
FGF23	positive	distal	Female
FGF5	NA	distal	Female
FHIT	NA	distal	Female
FIS1	positive	distal	Female
FKBP5	negative	distal	Female
FLI1	positive	distal	Female
FLRT2	positive	distal	Female
FLT3	negative	distal	Female
FLT3LG	positive	distal	Female
FLT4	negative	distal	Female
FOLR1	positive	distal	Female
FOLR2	positive	distal	Female
FOXO1	negative	distal	Female
FRZB	NA	distal	Female
FSTL3	NA	distal	Female
FUCA1	positive	distal	Female
FUS	NA	distal	Female
FUT3_FUT5	negative	distal	Female
FUT8	negative	distal	Female
FXN	positive	distal	Female
FXYD5	NA	distal	Female
FYB1	NA	distal	Female
GAL	positive	distal	Female
GALNT2	positive	distal	Female
GALNT7	positive	distal	Female
GAS6	negative	distal	Female
GFRA1	positive	distal	Female
GFRA2	negative	distal	Female
GFRA3	positive	distal	Female
GGH	negative	distal	Female
GGT5	negative	distal	Female
GHRL	negative	distal	Female
GKN1	negative	distal	Female
GLOD4	NA	distal	Female
GLRX	NA	distal	Female
GNE	positive	distal	Female
GOPC	NA	distal	Female
GPA33	negative	distal	Female
GPC1	negative	distal	Female
GPNMB	negative	distal	Female
GRAP2	positive	distal	Female
GRPEL1	positive	distal	Female
GUCA2A	positive	distal	Female
GYS1	positive	distal	Female
GZMH	positive	distal	Female
HARS1	NA	distal	Female
HAVCR1	negative	distal	Female
HAVCR2	negative	distal	Female
HBQ1	NA	distal	Female
HCLS1	positive	distal	Female
HDGF	NA	distal	Female
HEXIM1	positive	distal	Female
HGF	positive	distal	Female
HLA-DRA	positive	distal	Female
HMOX1	positive	distal	Female
HMOX2	negative	distal	Female
HS6ST1	positive	distal	Female
HSPB1	positive	distal	Female
HYAL1	negative	distal	Female
HYOU1	positive	distal	Female
ICA1	NA	distal	Female
ICAM1	positive	distal	Female
ICAM2	negative	distal	Female
ICAM3	negative	distal	Female
ICAM4	negative	distal	Female
ICAM5	positive	distal	Female
ICOSLG	negative	distal	Female
IDS	negative	distal	Female
IDUA	negative	distal	Female
IFNG	NA	distal	Female
IFNGR1	negative	distal	Female
IFNL1	negative	distal	Female
IFNLR1	NA	distal	Female
IGF2R	positive	distal	Female
IGFBP1	NA	distal	Female
IGFBP2	positive	distal	Female
IGFBP3	negative	distal	Female
IGFBP4	negative	distal	Female
IGFBP6	negative	distal	Female
IGFBP7	negative	distal	Female
IGFBPL1	NA	distal	Female
IGSF3	positive	distal	Female
IL10RB	positive	distal	Female
IL13RA1	NA	distal	Female
IL15	positive	distal	Female
IL17C	NA	distal	Female
IL17D	NA	distal	Female
IL17RB	negative	distal	Female
IL18BP	negative	distal	Female
IL18R1	negative	distal	Female
IL18RAP	positive	distal	Female
IL1B	NA	distal	Female
IL1R1	negative	distal	Female
IL1RAP	positive	distal	Female
IL1RL1	negative	distal	Female
IL1RL2	negative	distal	Female
IL1RN	NA	distal	Female
IL22RA1	NA	distal	Female
IL2RA	negative	distal	Female
IL32	negative	distal	Female
IL4R	positive	distal	Female
IL6	negative	distal	Female
IL6ST	negative	distal	Female
IL7	positive	distal	Female
IL7R	negative	distal	Female
IPCEF1	NA	distal	Female
IRAG2	NA	distal	Female
ISM1	NA	distal	Female
ITGA11	negative	distal	Female
ITGA5	negative	distal	Female
ITGA6	negative	distal	Female
ITGB1	negative	distal	Female
ITGB2	negative	distal	Female
ITGB6	negative	distal	Female
ITGB7	negative	distal	Female
JCHAIN	positive	distal	Female
KAZALD1	negative	distal	Female
KEL	negative	distal	Female
KIFBP	NA	distal	Female
KIR3DL1	NA	distal	Female
KLB	negative	distal	Female
KLK1	positive	distal	Female
KLK12	negative	distal	Female
KLK13	positive	distal	Female
KLK6	NA	distal	Female
KLK8	positive	distal	Female
KLRB1	negative	distal	Female
KRT18	negative	distal	Female
KRT5	negative	distal	Female
L1CAM	negative	distal	Female
LAMA4	positive	distal	Female
LAMP2	NA	distal	Female
LAT	positive	distal	Female
LBP	NA	distal	Female
LBR	positive	distal	Female
LDLR	positive	distal	Female
LEFTY2	negative	distal	Female
LEPR	negative	distal	Female
LGALS1	NA	distal	Female
LGALS3	positive	distal	Female
LGALS7_LGALS7B	negative	distal	Female
LGMN	negative	distal	Female
LILRA2	negative	distal	Female
LILRA5	negative	distal	Female
LILRB1	negative	distal	Female
LILRB2	negative	distal	Female
LILRB4	NA	distal	Female
LILRB5	NA	distal	Female
LPO	positive	distal	Female
LRIG1	positive	distal	Female
LRP1	positive	distal	Female
LRP11	positive	distal	Female
LRPAP1	positive	distal	Female
LRRN1	negative	distal	Female
LSP1	NA	distal	Female
LTA	negative	distal	Female
LTBP2	negative	distal	Female
LTBP3	negative	distal	Female
LY9	negative	distal	Female
LY96	negative	distal	Female
LYPD8	positive	distal	Female
MANF	positive	distal	Female
MAP2K6	NA	distal	Female
MAP4K5	NA	distal	Female
MARCO	negative	distal	Female
MASP1	positive	distal	Female
MATN2	negative	distal	Female
MATN3	positive	distal	Female
MAVS	positive	distal	Female
MAX	positive	distal	Female
MB	positive	distal	Female
MCFD2	negative	distal	Female
MEGF10	positive	distal	Female
MEGF9	negative	distal	Female
MERTK	negative	distal	Female
MESD	positive	distal	Female
METAP1D	NA	distal	Female
METAP2	positive	distal	Female
MFGE8	positive	distal	Female
MIA	positive	distal	Female
MICB_MICA	negative	distal	Female
MIF	negative	distal	Female
MILR1	positive	distal	Female
MITD1	NA	distal	Female
MME	negative	distal	Female
MMP1	negative	distal	Female
MMP10	NA	distal	Female
MMP12	NA	distal	Female
MMP3	negative	distal	Female
MMP7	negative	distal	Female
MMP8	NA	distal	Female
MMP9	positive	distal	Female
MPHOSPH8	NA	distal	Female
MPI	negative	distal	Female
MPIG6B	positive	distal	Female
MPO	negative	distal	Female
MSLN	positive	distal	Female
MSMB	negative	distal	Female
MSR1	positive	distal	Female
MSRA	NA	distal	Female
MUC13	positive	distal	Female
MUC16	NA	distal	Female
MZT1	NA	distal	Female
NAAA	positive	distal	Female
NADK	negative	distal	Female
NCAN	positive	distal	Female
NCR1	negative	distal	Female
NCS1	negative	distal	Female
NECTIN4	positive	distal	Female
NEFL	NA	distal	Female
NELL1	negative	distal	Female
NELL2	negative	distal	Female
NFKBIE	NA	distal	Female
NID1	negative	distal	Female
NID2	positive	distal	Female
NOS3	NA	distal	Female
NOTCH1	negative	distal	Female
NOTCH3	negative	distal	Female
NPPB	NA	distal	Female
NPPC	NA	distal	Female
NPTX1	positive	distal	Female
NPTXR	negative	distal	Female
NRCAM	positive	distal	Female
NRP2	positive	distal	Female
NSFL1C	NA	distal	Female
NTF3	negative	distal	Female
NTproBNP	negative	distal	Female
NUB1	positive	distal	Female
NUDC	NA	distal	Female
NUDT2	NA	distal	Female
NUDT5	NA	distal	Female
OBP2B	positive	distal	Female
ODAM	NA	distal	Female
OLR1	positive	distal	Female
OMG	positive	distal	Female
OPTC	negative	distal	Female
OSCAR	positive	distal	Female
OSM	positive	distal	Female
PAEP	negative	distal	Female
PAM	negative	distal	Female
PAPPA	positive	distal	Female
PARK7	negative	distal	Female
PARP1	NA	distal	Female
PCSK9	negative	distal	Female
PDCD1	negative	distal	Female
PDCD5	NA	distal	Female
PDCD6	negative	distal	Female
PDGFA	positive	distal	Female
PDGFC	negative	distal	Female
PDGFRA	negative	distal	Female
PEAR1	negative	distal	Female
PEBP1	NA	distal	Female
PGF	NA	distal	Female
PGLYRP1	positive	distal	Female
PI3	positive	distal	Female
PIGR	positive	distal	Female
PIK3IP1	positive	distal	Female
PILRB	negative	distal	Female
PKLR	positive	distal	Female
PLA2G10	negative	distal	Female
PLA2G1B	positive	distal	Female
PLA2G2A	negative	distal	Female
PLA2G4A	NA	distal	Female
PLAU	negative	distal	Female
PLIN3	NA	distal	Female
PLPBP	NA	distal	Female
PLTP	negative	distal	Female
PLXDC1	positive	distal	Female
PLXNA4	positive	distal	Female
PLXNB2	positive	distal	Female
PM20D1	positive	distal	Female
PMVK	negative	distal	Female
PNPT1	NA	distal	Female
PODXL	negative	distal	Female
PODXL2	positive	distal	Female
PON2	positive	distal	Female
PON3	negative	distal	Female
PPCDC	NA	distal	Female
PPP1R2	positive	distal	Female
PPP1R9B	NA	distal	Female
PRCP	negative	distal	Female
PRDX1	NA	distal	Female
PRDX5	NA	distal	Female
PRL	positive	distal	Female
PROC	negative	distal	Female
PROK1	NA	distal	Female
PRSS2	positive	distal	Female
PRSS27	positive	distal	Female
PRTFDC1	negative	distal	Female
PRTG	positive	distal	Female
PRTN3	positive	distal	Female
PSME1	NA	distal	Female
PSRC1	NA	distal	Female
PTGDS	NA	distal	Female
PTN	negative	distal	Female
PTPN1	NA	distal	Female
PTPN6	NA	distal	Female
PTPRS	positive	distal	Female
PVALB	positive	distal	Female
PVR	NA	distal	Female
PXN	negative	distal	Female
QPCT	negative	distal	Female
RAB6A	NA	distal	Female
RABGAP1L	NA	distal	Female
RAD23B	NA	distal	Female
RARRES2	negative	distal	Female
RBP5	negative	distal	Female
REG1A	negative	distal	Female
REG1B	negative	distal	Female
REG3A	negative	distal	Female
REG4	NA	distal	Female
RELT	positive	distal	Female
REN	NA	distal	Female
RET	positive	distal	Female
RETN	negative	distal	Female
RGMA	positive	distal	Female
RGMB	positive	distal	Female
RILP	positive	distal	Female
RNASE3	positive	distal	Female
RNASET2	positive	distal	Female
ROBO1	positive	distal	Female
ROBO2	negative	distal	Female
ROR1	positive	distal	Female
RP2	NA	distal	Female
RTBDN	NA	distal	Female
RTN4R	negative	distal	Female
RWDD1	NA	distal	Female
S100A11	NA	distal	Female
S100A12	negative	distal	Female
S100A16	negative	distal	Female
S100A4	negative	distal	Female
SAMD9L	NA	distal	Female
SCAMP3	positive	distal	Female
SCARB2	positive	distal	Female
SCARF2	negative	distal	Female
SCG3	positive	distal	Female
SCGB3A2	negative	distal	Female
SCGN	negative	distal	Female
SCRN1	NA	distal	Female
SDC1	negative	distal	Female
SEMA7A	negative	distal	Female
SEPTIN9	NA	distal	Female
SERPINA11	positive	distal	Female
SERPINA9	positive	distal	Female
SERPINB1	positive	distal	Female
SERPINB8	NA	distal	Female
SERPINB9	NA	distal	Female
SESTD1	positive	distal	Female
SEZ6L	positive	distal	Female
SEZ6L2	positive	distal	Female
SFRP1	positive	distal	Female
SFTPA2	negative	distal	Female
SFTPD	positive	distal	Female
SH2D1A	NA	distal	Female
SIGLEC1	negative	distal	Female
SIGLEC10	negative	distal	Female
SIGLEC7	negative	distal	Female
SIRPA	negative	distal	Female
SIRPB1	negative	distal	Female
SIRT2	NA	distal	Female
SIT1	negative	distal	Female
SKAP1	negative	distal	Female
SKAP2	positive	distal	Female
SLAMF1	negative	distal	Female
SLAMF8	positive	distal	Female
SLC39A14	NA	distal	Female
SLITRK2	negative	distal	Female
SLITRK6	negative	distal	Female
SMAD1	positive	distal	Female
SMOC1	positive	distal	Female
SMOC2	positive	distal	Female
SMPD1	positive	distal	Female
SNAP23	NA	distal	Female
SNAP29	positive	distal	Female
SNX9	NA	distal	Female
SOD2	positive	distal	Female
SORCS2	negative	distal	Female
SPARCL1	positive	distal	Female
SPINK4	negative	distal	Female
SPINT1	positive	distal	Female
SPINT2	positive	distal	Female
SPON1	negative	distal	Female
SPP1	negative	distal	Female
SPRY2	positive	distal	Female
SRP14	NA	distal	Female
SRPK2	positive	distal	Female
SSC4D	positive	distal	Female
ST6GAL1	positive	distal	Female
STAMBP	NA	distal	Female
STAT5B	NA	distal	Female
STIP1	NA	distal	Female
STK11	positive	distal	Female
STK24	NA	distal	Female
STK4	positive	distal	Female
STX4	NA	distal	Female
SULT2A1	positive	distal	Female
SUMF2	positive	distal	Female
SUSD1	negative	distal	Female
TAFA5	NA	distal	Female
TARBP2	NA	distal	Female
TBC1D5	NA	distal	Female
TBCB	positive	distal	Female
TBL1X	negative	distal	Female
TCL1A	positive	distal	Female
TDGF1	NA	distal	Female
TDRKH	positive	distal	Female
TFF1	negative	distal	Female
TFF2	negative	distal	Female
TFF3	negative	distal	Female
TFPI	positive	distal	Female
TFRC	negative	distal	Female
TGFB1	negative	distal	Female
TGFBI	negative	distal	Female
TGFBR3	negative	distal	Female
TGM2	NA	distal	Female
THBS2	negative	distal	Female
THBS4	negative	distal	Female
THY1	positive	distal	Female
TIA1	NA	distal	Female
TIE1	negative	distal	Female
TIGAR	NA	distal	Female
TIMP1	positive	distal	Female
TIMP3	positive	distal	Female
TIMP4	positive	distal	Female
TINAGL1	positive	distal	Female
TLR3	negative	distal	Female
TMPRSS15	negative	distal	Female
TNFRSF10A	positive	distal	Female
TNFRSF10C	negative	distal	Female
TNFRSF11A	negative	distal	Female
TNFRSF11B	positive	distal	Female
TNFRSF12A	NA	distal	Female
TNFRSF13B	positive	distal	Female
TNFRSF13C	positive	distal	Female
TNFRSF14	positive	distal	Female
TNFRSF19	negative	distal	Female
TNFRSF1B	negative	distal	Female
TNFRSF21	negative	distal	Female
TNFRSF4	negative	distal	Female
TNFRSF6B	positive	distal	Female
TNFSF10	negative	distal	Female
TNFSF12	positive	distal	Female
TNFSF13	negative	distal	Female
TNFSF14	negative	distal	Female
TNXB	positive	distal	Female
TPMT	NA	distal	Female
TPP1	negative	distal	Female
TPSAB1	negative	distal	Female
TREM2	positive	distal	Female
TREML2	negative	distal	Female
TRIM21	negative	distal	Female
TSHB	positive	distal	Female
TSPAN1	positive	distal	Female
TXLNA	NA	distal	Female
TXNDC15	positive	distal	Female
TXNDC5	positive	distal	Female
TYMP	NA	distal	Female
UMOD	negative	distal	Female
USO1	positive	distal	Female
UXS1	negative	distal	Female
VASN	negative	distal	Female
VCAM1	negative	distal	Female
VCAN	positive	distal	Female
VEGFA	positive	distal	Female
VMO1	negative	distal	Female
VNN2	positive	distal	Female
VPS37A	NA	distal	Female
VSIG4	positive	distal	Female
VSIR	negative	distal	Female
VSTM1	NA	distal	Female
VSTM2L	NA	distal	Female
VTA1	positive	distal	Female
VWF	negative	distal	Female
WAS	NA	distal	Female
WASF1	NA	distal	Female
WFDC12	positive	distal	Female
WFIKKN1	negative	distal	Female
WFIKKN2	negative	distal	Female
WWP2	NA	distal	Female
XCL1	positive	distal	Female
YES1	NA	distal	Female
ZBTB16	positive	distal	Female
ZBTB17	NA	distal	Female
