exposure	direction_group	outcome	group
AARSD1	negative	rectal	Male
ABHD14B	negative	rectal	Male
ACAA1	negative	rectal	Male
ACE2	negative	rectal	Male
ACP6	NA	rectal	Male
ACVRL1	positive	rectal	Male
ADAM22	positive	rectal	Male
ADAMTS13	negative	rectal	Male
ADAMTS15	positive	rectal	Male
ADAMTS8	positive	rectal	Male
ADH4	negative	rectal	Male
AFP	positive	rectal	Male
AGR2	negative	rectal	Male
AGR3	NA	rectal	Male
AGRN	positive	rectal	Male
AKR1B1	positive	rectal	Male
AKT1S1	NA	rectal	Male
ALCAM	positive	rectal	Male
ALPP	positive	rectal	Male
AMBP	negative	rectal	Male
AMN	negative	rectal	Male
AMY2A	negative	rectal	Male
AMY2B	negative	rectal	Male
ANG	negative	rectal	Male
ANGPT1	negative	rectal	Male
ANGPT2	positive	rectal	Male
ANGPTL1	negative	rectal	Male
ANGPTL7	negative	rectal	Male
ANPEP	negative	rectal	Male
ANXA11	NA	rectal	Male
ANXA4	NA	rectal	Male
AOC3	negative	rectal	Male
APBB1IP	positive	rectal	Male
APEX1	positive	rectal	Male
APLP1	positive	rectal	Male
APOM	negative	rectal	Male
APP	negative	rectal	Male
APRT	negative	rectal	Male
ARG1	negative	rectal	Male
ARHGAP1	NA	rectal	Male
ARHGAP25	NA	rectal	Male
ARSA	negative	rectal	Male
ASAH2	negative	rectal	Male
ASGR1	negative	rectal	Male
ATG4A	negative	rectal	Male
ATOX1	negative	rectal	Male
ATXN10	negative	rectal	Male
AXL	negative	rectal	Male
B4GALT1	positive	rectal	Male
B4GAT1	negative	rectal	Male
BACH1	NA	rectal	Male
BAG3	negative	rectal	Male
BANK1	NA	rectal	Male
BAX	NA	rectal	Male
BCL2L11	negative	rectal	Male
BGN	positive	rectal	Male
BID	NA	rectal	Male
BIN2	NA	rectal	Male
BLMH	positive	rectal	Male
BLVRB	NA	rectal	Male
BMP4	positive	rectal	Male
BOC	positive	rectal	Male
BRK1	negative	rectal	Male
BST1	negative	rectal	Male
BTC	negative	rectal	Male
BTN2A1	positive	rectal	Male
C19orf12	negative	rectal	Male
C1QA	negative	rectal	Male
C1QTNF1	positive	rectal	Male
C2	NA	rectal	Male
CA1	negative	rectal	Male
CA11	NA	rectal	Male
CA13	negative	rectal	Male
CA14	NA	rectal	Male
CA2	NA	rectal	Male
CA3	positive	rectal	Male
CA4	negative	rectal	Male
CA5A	negative	rectal	Male
CA6	negative	rectal	Male
CA9	positive	rectal	Male
CALB1	negative	rectal	Male
CAMKK1	negative	rectal	Male
CANT1	negative	rectal	Male
CAPG	NA	rectal	Male
CASP10	positive	rectal	Male
CASP2	NA	rectal	Male
CASP3	NA	rectal	Male
CASP8	positive	rectal	Male
CBLIF	positive	rectal	Male
CBLN4	positive	rectal	Male
CC2D1A	NA	rectal	Male
CCL11	negative	rectal	Male
CCL13	negative	rectal	Male
CCL14	negative	rectal	Male
CCL15	negative	rectal	Male
CCL16	positive	rectal	Male
CCL19	positive	rectal	Male
CCL24	negative	rectal	Male
CCL25	negative	rectal	Male
CCL28	negative	rectal	Male
CCL3	negative	rectal	Male
CCL5	negative	rectal	Male
CCL8	negative	rectal	Male
CCN1	negative	rectal	Male
CCN4	positive	rectal	Male
CD163	positive	rectal	Male
CD177	negative	rectal	Male
CD1C	negative	rectal	Male
CD200	negative	rectal	Male
CD207	negative	rectal	Male
CD22	positive	rectal	Male
CD28	negative	rectal	Male
CD300C	positive	rectal	Male
CD302	positive	rectal	Male
CD33	negative	rectal	Male
CD38	NA	rectal	Male
CD40LG	negative	rectal	Male
CD48	negative	rectal	Male
CD5	negative	rectal	Male
CD55	negative	rectal	Male
CD58	negative	rectal	Male
CD63	negative	rectal	Male
CD69	negative	rectal	Male
CD93	negative	rectal	Male
CDC27	NA	rectal	Male
CDC37	NA	rectal	Male
CDH1	negative	rectal	Male
CDH15	NA	rectal	Male
CDH17	negative	rectal	Male
CDH5	negative	rectal	Male
CDH6	positive	rectal	Male
CDHR1	positive	rectal	Male
CDHR2	negative	rectal	Male
CEACAM1	positive	rectal	Male
CEACAM21	NA	rectal	Male
CEACAM3	NA	rectal	Male
CEP20	negative	rectal	Male
CEP43	positive	rectal	Male
CERT	negative	rectal	Male
CES2	NA	rectal	Male
CHAC2	NA	rectal	Male
CHGB	positive	rectal	Male
CHI3L1	negative	rectal	Male
CHIT1	negative	rectal	Male
CHL1	positive	rectal	Male
CHMP1A	negative	rectal	Male
CHRDL2	positive	rectal	Male
CIAPIN1	negative	rectal	Male
CKAP4	negative	rectal	Male
CLC	negative	rectal	Male
CLEC10A	positive	rectal	Male
CLEC11A	negative	rectal	Male
CLEC1A	negative	rectal	Male
CLEC4D	negative	rectal	Male
CLEC5A	positive	rectal	Male
CLEC6A	positive	rectal	Male
CLIP2	NA	rectal	Male
CLSTN2	positive	rectal	Male
CLUL1	negative	rectal	Male
CNDP1	positive	rectal	Male
CNPY4	NA	rectal	Male
CNST	negative	rectal	Male
CNTN2	positive	rectal	Male
CNTN3	negative	rectal	Male
CNTN5	negative	rectal	Male
CNTNAP2	negative	rectal	Male
COL18A1	positive	rectal	Male
COL4A1	negative	rectal	Male
COL6A3	positive	rectal	Male
COL9A1	negative	rectal	Male
COLEC12	negative	rectal	Male
COMP	positive	rectal	Male
COMT	NA	rectal	Male
CORO1A	negative	rectal	Male
COX5B	positive	rectal	Male
CPA2	negative	rectal	Male
CPB1	positive	rectal	Male
CPM	positive	rectal	Male
CPVL	positive	rectal	Male
CPXM1	negative	rectal	Male
CRACR2A	negative	rectal	Male
CRADD	negative	rectal	Male
CREG1	negative	rectal	Male
CRELD2	positive	rectal	Male
CRH	positive	rectal	Male
CRHBP	negative	rectal	Male
CRIP2	negative	rectal	Male
CRISP2	positive	rectal	Male
CRNN	positive	rectal	Male
CRTAC1	NA	rectal	Male
CRTAM	negative	rectal	Male
CST5	positive	rectal	Male
CST6	negative	rectal	Male
CTF1	NA	rectal	Male
CTRB1	positive	rectal	Male
CTSB	positive	rectal	Male
CTSC	positive	rectal	Male
CTSD	positive	rectal	Male
CTSL	negative	rectal	Male
CTSZ	negative	rectal	Male
CXADR	negative	rectal	Male
CXCL1	negative	rectal	Male
CXCL12	negative	rectal	Male
CXCL13	positive	rectal	Male
CXCL14	NA	rectal	Male
CXCL3	negative	rectal	Male
DAB2	NA	rectal	Male
DAG1	negative	rectal	Male
DAPP1	NA	rectal	Male
DARS1	negative	rectal	Male
DBI	positive	rectal	Male
DDAH1	negative	rectal	Male
DDC	negative	rectal	Male
DDR1	positive	rectal	Male
DECR1	negative	rectal	Male
DEFA1_DEFA1B	positive	rectal	Male
DFFA	NA	rectal	Male
DIABLO	negative	rectal	Male
DKK1	negative	rectal	Male
DKK3	negative	rectal	Male
DKK4	positive	rectal	Male
DKKL1	positive	rectal	Male
DNAJB1	negative	rectal	Male
DNER	negative	rectal	Male
DNMBP	positive	rectal	Male
DOK2	negative	rectal	Male
DPEP1	positive	rectal	Male
DPP4	negative	rectal	Male
DPT	NA	rectal	Male
DPY30	NA	rectal	Male
DRAXIN	negative	rectal	Male
DRG2	negative	rectal	Male
DSG3	negative	rectal	Male
DSG4	negative	rectal	Male
DTX3	positive	rectal	Male
DUSP3	NA	rectal	Male
ECE1	positive	rectal	Male
EDAR	positive	rectal	Male
EDIL3	NA	rectal	Male
EFEMP1	negative	rectal	Male
EGF	negative	rectal	Male
EGLN1	negative	rectal	Male
ELOA	NA	rectal	Male
ENG	negative	rectal	Male
ENO1	negative	rectal	Male
ENO2	negative	rectal	Male
ENPP2	negative	rectal	Male
ENPP5	negative	rectal	Male
ENPP7	positive	rectal	Male
ENTPD2	NA	rectal	Male
ENTPD5	negative	rectal	Male
EPHA1	negative	rectal	Male
EPHB4	negative	rectal	Male
EPHB6	positive	rectal	Male
EPS8L2	negative	rectal	Male
ERBIN	NA	rectal	Male
ESAM	negative	rectal	Male
F11R	negative	rectal	Male
F3	negative	rectal	Male
F7	negative	rectal	Male
F9	NA	rectal	Male
FABP1	NA	rectal	Male
FABP2	negative	rectal	Male
FABP5	NA	rectal	Male
FABP6	NA	rectal	Male
FADD	positive	rectal	Male
FAM3B	positive	rectal	Male
FAS	negative	rectal	Male
FASLG	negative	rectal	Male
FCAR	positive	rectal	Male
FCN2	positive	rectal	Male
FCRL2	negative	rectal	Male
FCRL6	positive	rectal	Male
FCRLB	negative	rectal	Male
FETUB	negative	rectal	Male
FGF19	negative	rectal	Male
FGF2	negative	rectal	Male
FGF21	negative	rectal	Male
FGF23	positive	rectal	Male
FGF5	NA	rectal	Male
FGFR2	positive	rectal	Male
FHIT	NA	rectal	Male
FIS1	positive	rectal	Male
FKBP1B	negative	rectal	Male
FKBP5	negative	rectal	Male
FLI1	negative	rectal	Male
FLRT2	positive	rectal	Male
FLT1	negative	rectal	Male
FOLR1	positive	rectal	Male
FOXO1	positive	rectal	Male
FRZB	NA	rectal	Male
FSTL3	NA	rectal	Male
FUCA1	negative	rectal	Male
FURIN	negative	rectal	Male
FUS	NA	rectal	Male
FUT3_FUT5	negative	rectal	Male
FUT8	negative	rectal	Male
FXN	negative	rectal	Male
FXYD5	NA	rectal	Male
FYB1	NA	rectal	Male
GAL	positive	rectal	Male
GALNT2	positive	rectal	Male
GAS6	negative	rectal	Male
GDF2	negative	rectal	Male
GFRA2	negative	rectal	Male
GFRA3	positive	rectal	Male
GGH	negative	rectal	Male
GGT1	negative	rectal	Male
GGT5	positive	rectal	Male
GHRL	negative	rectal	Male
GKN1	negative	rectal	Male
GLOD4	NA	rectal	Male
GLRX	NA	rectal	Male
GNLY	positive	rectal	Male
GOLM2	positive	rectal	Male
GOPC	NA	rectal	Male
GP1BA	negative	rectal	Male
GP6	negative	rectal	Male
GPA33	positive	rectal	Male
GPC1	positive	rectal	Male
GPC5	negative	rectal	Male
GPNMB	positive	rectal	Male
GPR37	negative	rectal	Male
GRN	positive	rectal	Male
GUCA2A	negative	rectal	Male
GYS1	negative	rectal	Male
HAO1	positive	rectal	Male
HARS1	NA	rectal	Male
HAVCR2	positive	rectal	Male
HBQ1	NA	rectal	Male
HCLS1	positive	rectal	Male
HDGF	NA	rectal	Male
HGF	positive	rectal	Male
HLA-DRA	positive	rectal	Male
HMOX1	positive	rectal	Male
HMOX2	positive	rectal	Male
HNMT	positive	rectal	Male
HS3ST3B1	positive	rectal	Male
HS6ST1	positive	rectal	Male
HSD11B1	negative	rectal	Male
HSPG2	negative	rectal	Male
HYAL1	negative	rectal	Male
ICA1	NA	rectal	Male
ICAM5	negative	rectal	Male
ICOSLG	positive	rectal	Male
IFNG	NA	rectal	Male
IFNGR1	negative	rectal	Male
IFNGR2	negative	rectal	Male
IFNLR1	NA	rectal	Male
IGF2R	positive	rectal	Male
IGFBP1	NA	rectal	Male
IGFBP3	negative	rectal	Male
IGFBP4	negative	rectal	Male
IGFBP6	negative	rectal	Male
IGFBP7	negative	rectal	Male
IGFBPL1	NA	rectal	Male
IGSF8	positive	rectal	Male
IL10RB	negative	rectal	Male
IL13RA1	NA	rectal	Male
IL15	positive	rectal	Male
IL17C	NA	rectal	Male
IL17D	NA	rectal	Male
IL17RA	positive	rectal	Male
IL17RB	positive	rectal	Male
IL18R1	negative	rectal	Male
IL18RAP	negative	rectal	Male
IL1B	NA	rectal	Male
IL1R2	positive	rectal	Male
IL1RAP	positive	rectal	Male
IL1RN	NA	rectal	Male
IL22RA1	NA	rectal	Male
IL2RA	negative	rectal	Male
IL32	positive	rectal	Male
IL3RA	positive	rectal	Male
IL4R	positive	rectal	Male
IL5RA	negative	rectal	Male
IL6ST	positive	rectal	Male
IL7	negative	rectal	Male
INHBC	negative	rectal	Male
IPCEF1	NA	rectal	Male
IRAG2	NA	rectal	Male
ISLR2	negative	rectal	Male
ISM1	NA	rectal	Male
ITGA6	positive	rectal	Male
KAZALD1	negative	rectal	Male
KDR	positive	rectal	Male
KIFBP	NA	rectal	Male
KIR3DL1	NA	rectal	Male
KLB	negative	rectal	Male
KLK1	positive	rectal	Male
KLK11	positive	rectal	Male
KLK12	negative	rectal	Male
KLK4	negative	rectal	Male
KLK6	NA	rectal	Male
KLK8	negative	rectal	Male
KLRB1	negative	rectal	Male
KRT18	negative	rectal	Male
KRT19	negative	rectal	Male
KYAT1	negative	rectal	Male
L1CAM	positive	rectal	Male
LACTB2	negative	rectal	Male
LAIR2	positive	rectal	Male
LAMP2	NA	rectal	Male
LAT	negative	rectal	Male
LBP	NA	rectal	Male
LBR	negative	rectal	Male
LEPR	negative	rectal	Male
LGALS1	NA	rectal	Male
LGALS3	positive	rectal	Male
LGALS7_LGALS7B	negative	rectal	Male
LGMN	negative	rectal	Male
LILRA2	positive	rectal	Male
LILRA5	negative	rectal	Male
LILRB1	positive	rectal	Male
LILRB2	positive	rectal	Male
LILRB4	NA	rectal	Male
LILRB5	NA	rectal	Male
LPO	positive	rectal	Male
LRP1	positive	rectal	Male
LRP11	positive	rectal	Male
LRPAP1	positive	rectal	Male
LSP1	NA	rectal	Male
LTA	negative	rectal	Male
LTBP3	negative	rectal	Male
LY6D	positive	rectal	Male
LY9	negative	rectal	Male
LYPD8	positive	rectal	Male
MANF	negative	rectal	Male
MANSC1	positive	rectal	Male
MAP2K6	NA	rectal	Male
MAP4K5	NA	rectal	Male
MARCO	positive	rectal	Male
MASP1	negative	rectal	Male
MATN2	negative	rectal	Male
MATN3	negative	rectal	Male
MB	negative	rectal	Male
MDGA1	positive	rectal	Male
MDK	negative	rectal	Male
MEGF10	positive	rectal	Male
MEGF9	positive	rectal	Male
MEPE	negative	rectal	Male
MERTK	negative	rectal	Male
MESD	negative	rectal	Male
MET	negative	rectal	Male
METAP1D	NA	rectal	Male
MFAP5	negative	rectal	Male
MFGE8	positive	rectal	Male
MGLL	negative	rectal	Male
MGMT	positive	rectal	Male
MIA	positive	rectal	Male
MILR1	positive	rectal	Male
MITD1	NA	rectal	Male
MME	positive	rectal	Male
MMP1	negative	rectal	Male
MMP10	NA	rectal	Male
MMP12	NA	rectal	Male
MMP3	positive	rectal	Male
MMP7	negative	rectal	Male
MMP8	NA	rectal	Male
MMP9	negative	rectal	Male
MPHOSPH8	NA	rectal	Male
MPI	negative	rectal	Male
MPIG6B	negative	rectal	Male
MPO	positive	rectal	Male
MSLN	positive	rectal	Male
MSR1	negative	rectal	Male
MSRA	NA	rectal	Male
MUC13	positive	rectal	Male
MUC16	NA	rectal	Male
MZT1	NA	rectal	Male
NAAA	positive	rectal	Male
NADK	negative	rectal	Male
NBL1	positive	rectal	Male
NCAM1	positive	rectal	Male
NCAM2	positive	rectal	Male
NCAN	positive	rectal	Male
NCF2	positive	rectal	Male
NCR1	negative	rectal	Male
NCS1	positive	rectal	Male
NECTIN4	negative	rectal	Male
NEFL	NA	rectal	Male
NELL1	positive	rectal	Male
NFASC	positive	rectal	Male
NFKBIE	NA	rectal	Male
NID2	positive	rectal	Male
NME3	negative	rectal	Male
NMNAT1	negative	rectal	Male
NOMO1	negative	rectal	Male
NOS3	NA	rectal	Male
NOTCH1	negative	rectal	Male
NOTCH3	positive	rectal	Male
NPDC1	negative	rectal	Male
NPPB	NA	rectal	Male
NPPC	NA	rectal	Male
NPTX1	positive	rectal	Male
NPY	negative	rectal	Male
NRP2	positive	rectal	Male
NSFL1C	NA	rectal	Male
NT5E	positive	rectal	Male
NTF3	negative	rectal	Male
NUB1	positive	rectal	Male
NUDC	NA	rectal	Male
NUDT2	NA	rectal	Male
NUDT5	NA	rectal	Male
OBP2B	positive	rectal	Male
ODAM	NA	rectal	Male
OGN	positive	rectal	Male
OLR1	negative	rectal	Male
OPTC	negative	rectal	Male
OSMR	positive	rectal	Male
OXT	negative	rectal	Male
PAEP	positive	rectal	Male
PAG1	negative	rectal	Male
PAM	negative	rectal	Male
PARK7	negative	rectal	Male
PARP1	NA	rectal	Male
PDCD5	NA	rectal	Male
PDGFC	positive	rectal	Male
PEBP1	NA	rectal	Male
PFKFB2	positive	rectal	Male
PGF	NA	rectal	Male
PGLYRP1	positive	rectal	Male
PI3	positive	rectal	Male
PIK3AP1	negative	rectal	Male
PIK3IP1	negative	rectal	Male
PILRA	positive	rectal	Male
PILRB	positive	rectal	Male
PKLR	positive	rectal	Male
PLA2G10	negative	rectal	Male
PLA2G15	negative	rectal	Male
PLA2G1B	positive	rectal	Male
PLA2G2A	negative	rectal	Male
PLA2G4A	NA	rectal	Male
PLA2G7	positive	rectal	Male
PLAU	positive	rectal	Male
PLIN3	NA	rectal	Male
PLPBP	NA	rectal	Male
PLTP	positive	rectal	Male
PLXNB2	positive	rectal	Male
PLXNB3	negative	rectal	Male
PMVK	negative	rectal	Male
PNPT1	NA	rectal	Male
PODXL	negative	rectal	Male
PODXL2	positive	rectal	Male
PON3	positive	rectal	Male
PPCDC	NA	rectal	Male
PPIB	negative	rectal	Male
PPP1R9B	NA	rectal	Male
PRCP	negative	rectal	Male
PRDX1	NA	rectal	Male
PRDX5	NA	rectal	Male
PRKAR1A	positive	rectal	Male
PRL	negative	rectal	Male
PROK1	NA	rectal	Male
PRSS2	positive	rectal	Male
PRSS27	positive	rectal	Male
PRTFDC1	negative	rectal	Male
PRTG	positive	rectal	Male
PRTN3	positive	rectal	Male
PSG1	negative	rectal	Male
PSIP1	negative	rectal	Male
PSME1	NA	rectal	Male
PSRC1	NA	rectal	Male
PTGDS	NA	rectal	Male
PTN	negative	rectal	Male
PTPN1	NA	rectal	Male
PTPN6	NA	rectal	Male
PTPRF	positive	rectal	Male
PTPRM	negative	rectal	Male
PTPRS	positive	rectal	Male
PTS	negative	rectal	Male
PTX3	negative	rectal	Male
PVR	NA	rectal	Male
QPCT	positive	rectal	Male
RAB6A	NA	rectal	Male
RABGAP1L	NA	rectal	Male
RAD23B	NA	rectal	Male
RBP5	positive	rectal	Male
REG1B	negative	rectal	Male
REG3A	negative	rectal	Male
REG4	NA	rectal	Male
REN	NA	rectal	Male
RET	negative	rectal	Male
RETN	negative	rectal	Male
RNASE3	positive	rectal	Male
RNASET2	negative	rectal	Male
ROBO1	negative	rectal	Male
ROR1	positive	rectal	Male
RP2	NA	rectal	Male
RSPO3	positive	rectal	Male
RTBDN	NA	rectal	Male
RWDD1	NA	rectal	Male
S100A11	NA	rectal	Male
S100A12	positive	rectal	Male
S100A16	positive	rectal	Male
S100A4	negative	rectal	Male
SAMD9L	NA	rectal	Male
SCAMP3	negative	rectal	Male
SCARB2	negative	rectal	Male
SCARF2	positive	rectal	Male
SCG3	positive	rectal	Male
SCGN	negative	rectal	Male
SCLY	negative	rectal	Male
SCRN1	NA	rectal	Male
SDC4	negative	rectal	Male
SELE	negative	rectal	Male
SELPLG	positive	rectal	Male
SEMA4D	negative	rectal	Male
SEPTIN9	NA	rectal	Male
SERPINA11	positive	rectal	Male
SERPINA12	positive	rectal	Male
SERPINB8	NA	rectal	Male
SERPINB9	NA	rectal	Male
SESTD1	negative	rectal	Male
SETMAR	NA	rectal	Male
SEZ6L	positive	rectal	Male
SF3B4	negative	rectal	Male
SFRP1	negative	rectal	Male
SFTPA2	negative	rectal	Male
SFTPD	positive	rectal	Male
SH2D1A	NA	rectal	Male
SHMT1	positive	rectal	Male
SIGLEC5	positive	rectal	Male
SIGLEC6	negative	rectal	Male
SIRPA	positive	rectal	Male
SIRPB1	positive	rectal	Male
SIRT2	NA	rectal	Male
SIT1	negative	rectal	Male
SKAP2	negative	rectal	Male
SLAMF1	positive	rectal	Male
SLAMF7	negative	rectal	Male
SLC27A4	negative	rectal	Male
SLC39A14	NA	rectal	Male
SLC39A5	negative	rectal	Male
SLITRK2	positive	rectal	Male
SLITRK6	positive	rectal	Male
SMOC1	positive	rectal	Male
SMOC2	positive	rectal	Male
SMPD1	negative	rectal	Male
SNAP23	NA	rectal	Male
SNX9	NA	rectal	Male
SOD1	negative	rectal	Male
SOD2	negative	rectal	Male
SOST	positive	rectal	Male
SPARCL1	positive	rectal	Male
SPINK4	negative	rectal	Male
SPINK5	positive	rectal	Male
SPINT1	positive	rectal	Male
SPINT2	negative	rectal	Male
SPOCK1	negative	rectal	Male
SRP14	NA	rectal	Male
SSC5D	positive	rectal	Male
ST3GAL1	negative	rectal	Male
ST6GAL1	negative	rectal	Male
STAT5B	NA	rectal	Male
STIP1	NA	rectal	Male
STK24	NA	rectal	Male
STK4	negative	rectal	Male
STX4	NA	rectal	Male
STX8	negative	rectal	Male
SULT2A1	positive	rectal	Male
SUMF2	negative	rectal	Male
SUSD1	negative	rectal	Male
SUSD2	positive	rectal	Male
TAFA5	NA	rectal	Male
TARBP2	NA	rectal	Male
TBC1D23	positive	rectal	Male
TBC1D5	NA	rectal	Male
TBCB	negative	rectal	Male
TCL1A	negative	rectal	Male
TDGF1	NA	rectal	Male
TDRKH	positive	rectal	Male
TFF1	positive	rectal	Male
TFF3	negative	rectal	Male
TFPI	positive	rectal	Male
TFPI2	negative	rectal	Male
TFRC	positive	rectal	Male
TGFA	negative	rectal	Male
TGFB1	positive	rectal	Male
TGFBR3	negative	rectal	Male
TGM2	NA	rectal	Male
THBS2	positive	rectal	Male
THBS4	positive	rectal	Male
THY1	negative	rectal	Male
TIA1	NA	rectal	Male
TIE1	negative	rectal	Male
TIGAR	NA	rectal	Male
TIMD4	positive	rectal	Male
TIMP3	negative	rectal	Male
TINAGL1	positive	rectal	Male
TLR3	positive	rectal	Male
TMPRSS15	negative	rectal	Male
TMPRSS5	positive	rectal	Male
TNC	positive	rectal	Male
TNF	negative	rectal	Male
TNFRSF10A	negative	rectal	Male
TNFRSF10B	negative	rectal	Male
TNFRSF10C	negative	rectal	Male
TNFRSF11A	positive	rectal	Male
TNFRSF11B	negative	rectal	Male
TNFRSF12A	NA	rectal	Male
TNFRSF13C	positive	rectal	Male
TNFRSF14	positive	rectal	Male
TNFRSF19	positive	rectal	Male
TNFRSF4	negative	rectal	Male
TNFRSF6B	positive	rectal	Male
TNFRSF9	positive	rectal	Male
TNFSF13	positive	rectal	Male
TNR	negative	rectal	Male
TNXB	positive	rectal	Male
TPMT	NA	rectal	Male
TPP1	negative	rectal	Male
TREM2	positive	rectal	Male
TREML2	positive	rectal	Male
TRIM21	negative	rectal	Male
TSHB	positive	rectal	Male
TXLNA	NA	rectal	Male
TXNDC15	positive	rectal	Male
TXNDC5	negative	rectal	Male
TYMP	NA	rectal	Male
TYRO3	positive	rectal	Male
ULBP2	negative	rectal	Male
UMOD	negative	rectal	Male
USO1	negative	rectal	Male
USP8	negative	rectal	Male
UXS1	negative	rectal	Male
VASH1	negative	rectal	Male
VCAM1	negative	rectal	Male
VEGFA	positive	rectal	Male
VEGFC	negative	rectal	Male
VEGFD	positive	rectal	Male
VMO1	positive	rectal	Male
VPS37A	NA	rectal	Male
VSIR	negative	rectal	Male
VSTM1	NA	rectal	Male
VSTM2L	NA	rectal	Male
WAS	NA	rectal	Male
WASF1	NA	rectal	Male
WFDC2	positive	rectal	Male
WFIKKN2	negative	rectal	Male
WIF1	negative	rectal	Male
WWP2	NA	rectal	Male
XCL1	negative	rectal	Male
XPNPEP2	positive	rectal	Male
YES1	NA	rectal	Male
ZBTB16	negative	rectal	Male
ZBTB17	NA	rectal	Male
