exposure	direction_group	outcome	group
ACE2	negative	distal	Sex-combined
ACP5	positive	distal	Sex-combined
ACP6	NA	distal	Sex-combined
ACVRL1	negative	distal	Sex-combined
ADAM15	positive	distal	Sex-combined
ADAMTS8	positive	distal	Sex-combined
ADGRB3	negative	distal	Sex-combined
ADGRG1	negative	distal	Sex-combined
ADGRG2	negative	distal	Sex-combined
AFP	positive	distal	Sex-combined
AGR2	negative	distal	Sex-combined
AGR3	NA	distal	Sex-combined
AGRP	positive	distal	Sex-combined
AHSP	negative	distal	Sex-combined
AKR1B1	positive	distal	Sex-combined
AKT1S1	NA	distal	Sex-combined
ALDH1A1	positive	distal	Sex-combined
ALPP	positive	distal	Sex-combined
AMBP	negative	distal	Sex-combined
AMY2A	negative	distal	Sex-combined
AMY2B	negative	distal	Sex-combined
ANGPT2	positive	distal	Sex-combined
ANGPTL1	negative	distal	Sex-combined
ANGPTL7	negative	distal	Sex-combined
ANPEP	negative	distal	Sex-combined
ANXA11	NA	distal	Sex-combined
ANXA3	positive	distal	Sex-combined
ANXA4	NA	distal	Sex-combined
AOC3	negative	distal	Sex-combined
APOM	negative	distal	Sex-combined
AREG	positive	distal	Sex-combined
ARG1	negative	distal	Sex-combined
ARHGAP1	NA	distal	Sex-combined
ARHGAP25	NA	distal	Sex-combined
ARSA	negative	distal	Sex-combined
ARSB	positive	distal	Sex-combined
ART3	negative	distal	Sex-combined
ASAH2	negative	distal	Sex-combined
ASGR1	negative	distal	Sex-combined
ATG4A	negative	distal	Sex-combined
ATOX1	positive	distal	Sex-combined
ATP5IF1	positive	distal	Sex-combined
ATXN10	negative	distal	Sex-combined
AXL	negative	distal	Sex-combined
B4GALT1	positive	distal	Sex-combined
B4GAT1	negative	distal	Sex-combined
BACH1	NA	distal	Sex-combined
BAG3	negative	distal	Sex-combined
BANK1	NA	distal	Sex-combined
BAX	NA	distal	Sex-combined
BCAM	negative	distal	Sex-combined
BID	NA	distal	Sex-combined
BIN2	NA	distal	Sex-combined
BLMH	negative	distal	Sex-combined
BLVRB	NA	distal	Sex-combined
BMP6	negative	distal	Sex-combined
BOC	positive	distal	Sex-combined
BRK1	positive	distal	Sex-combined
BSG	negative	distal	Sex-combined
BST1	positive	distal	Sex-combined
BTC	negative	distal	Sex-combined
BTN2A1	positive	distal	Sex-combined
C1QTNF1	positive	distal	Sex-combined
C2	NA	distal	Sex-combined
C4BPB	negative	distal	Sex-combined
CA1	negative	distal	Sex-combined
CA11	NA	distal	Sex-combined
CA13	negative	distal	Sex-combined
CA14	NA	distal	Sex-combined
CA2	NA	distal	Sex-combined
CA4	negative	distal	Sex-combined
CA5A	positive	distal	Sex-combined
CA6	negative	distal	Sex-combined
CALB1	negative	distal	Sex-combined
CALCA	positive	distal	Sex-combined
CAMKK1	negative	distal	Sex-combined
CANT1	positive	distal	Sex-combined
CAPG	NA	distal	Sex-combined
CASP2	NA	distal	Sex-combined
CASP3	NA	distal	Sex-combined
CASP8	negative	distal	Sex-combined
CBLIF	positive	distal	Sex-combined
CBLN4	positive	distal	Sex-combined
CC2D1A	NA	distal	Sex-combined
CCL11	negative	distal	Sex-combined
CCL14	negative	distal	Sex-combined
CCL16	positive	distal	Sex-combined
CCL17	positive	distal	Sex-combined
CCL24	negative	distal	Sex-combined
CCL25	negative	distal	Sex-combined
CCL26	negative	distal	Sex-combined
CCL27	positive	distal	Sex-combined
CCL28	negative	distal	Sex-combined
CCL3	negative	distal	Sex-combined
CCL7	negative	distal	Sex-combined
CCN1	negative	distal	Sex-combined
CCN2	positive	distal	Sex-combined
CCN4	positive	distal	Sex-combined
CD14	negative	distal	Sex-combined
CD163	positive	distal	Sex-combined
CD164	negative	distal	Sex-combined
CD177	negative	distal	Sex-combined
CD1C	negative	distal	Sex-combined
CD200	negative	distal	Sex-combined
CD207	negative	distal	Sex-combined
CD209	positive	distal	Sex-combined
CD22	positive	distal	Sex-combined
CD244	negative	distal	Sex-combined
CD28	negative	distal	Sex-combined
CD300C	positive	distal	Sex-combined
CD300E	negative	distal	Sex-combined
CD300LG	negative	distal	Sex-combined
CD302	negative	distal	Sex-combined
CD33	negative	distal	Sex-combined
CD34	negative	distal	Sex-combined
CD38	NA	distal	Sex-combined
CD40	negative	distal	Sex-combined
CD46	negative	distal	Sex-combined
CD48	negative	distal	Sex-combined
CD5	negative	distal	Sex-combined
CD55	negative	distal	Sex-combined
CD58	negative	distal	Sex-combined
CD59	positive	distal	Sex-combined
CD79B	negative	distal	Sex-combined
CD84	negative	distal	Sex-combined
CD99L2	negative	distal	Sex-combined
CDC27	NA	distal	Sex-combined
CDC37	NA	distal	Sex-combined
CDCP1	negative	distal	Sex-combined
CDH1	negative	distal	Sex-combined
CDH15	NA	distal	Sex-combined
CDH17	negative	distal	Sex-combined
CDH5	negative	distal	Sex-combined
CDH6	negative	distal	Sex-combined
CDHR1	positive	distal	Sex-combined
CDHR2	negative	distal	Sex-combined
CDKN1A	negative	distal	Sex-combined
CDKN2D	positive	distal	Sex-combined
CDON	negative	distal	Sex-combined
CDSN	positive	distal	Sex-combined
CEACAM1	positive	distal	Sex-combined
CEACAM21	NA	distal	Sex-combined
CEACAM3	NA	distal	Sex-combined
CES1	negative	distal	Sex-combined
CES2	NA	distal	Sex-combined
CES3	negative	distal	Sex-combined
CETN2	positive	distal	Sex-combined
CGREF1	negative	distal	Sex-combined
CHAC2	NA	distal	Sex-combined
CHI3L1	negative	distal	Sex-combined
CHIT1	negative	distal	Sex-combined
CHL1	positive	distal	Sex-combined
CHMP1A	negative	distal	Sex-combined
CHRDL1	negative	distal	Sex-combined
CKAP4	negative	distal	Sex-combined
CKMT1A_CKMT1B	negative	distal	Sex-combined
CLC	negative	distal	Sex-combined
CLEC10A	positive	distal	Sex-combined
CLEC11A	negative	distal	Sex-combined
CLEC14A	negative	distal	Sex-combined
CLEC1A	negative	distal	Sex-combined
CLEC1B	negative	distal	Sex-combined
CLEC4C	negative	distal	Sex-combined
CLEC4D	positive	distal	Sex-combined
CLEC4G	negative	distal	Sex-combined
CLIP2	NA	distal	Sex-combined
CLSTN2	positive	distal	Sex-combined
CLUL1	negative	distal	Sex-combined
CNPY4	NA	distal	Sex-combined
CNTN1	positive	distal	Sex-combined
CNTN2	positive	distal	Sex-combined
CNTN3	negative	distal	Sex-combined
CNTN5	negative	distal	Sex-combined
COL18A1	positive	distal	Sex-combined
COL9A1	positive	distal	Sex-combined
COLEC12	negative	distal	Sex-combined
COMT	NA	distal	Sex-combined
CORO1A	positive	distal	Sex-combined
CPA2	negative	distal	Sex-combined
CPM	positive	distal	Sex-combined
CPVL	negative	distal	Sex-combined
CPXM1	negative	distal	Sex-combined
CR2	positive	distal	Sex-combined
CRADD	negative	distal	Sex-combined
CREG1	negative	distal	Sex-combined
CRELD2	positive	distal	Sex-combined
CRH	positive	distal	Sex-combined
CRHBP	negative	distal	Sex-combined
CRIM1	negative	distal	Sex-combined
CRIP2	negative	distal	Sex-combined
CRNN	positive	distal	Sex-combined
CRTAC1	NA	distal	Sex-combined
CRTAM	negative	distal	Sex-combined
CST6	negative	distal	Sex-combined
CST7	positive	distal	Sex-combined
CTF1	NA	distal	Sex-combined
CTRB1	positive	distal	Sex-combined
CTRC	positive	distal	Sex-combined
CTSB	positive	distal	Sex-combined
CTSC	positive	distal	Sex-combined
CTSD	positive	distal	Sex-combined
CTSZ	negative	distal	Sex-combined
CX3CL1	negative	distal	Sex-combined
CXCL1	negative	distal	Sex-combined
CXCL10	negative	distal	Sex-combined
CXCL11	negative	distal	Sex-combined
CXCL13	positive	distal	Sex-combined
CXCL14	NA	distal	Sex-combined
CXCL16	positive	distal	Sex-combined
CXCL3	negative	distal	Sex-combined
CXCL5	negative	distal	Sex-combined
CXCL6	positive	distal	Sex-combined
CXCL8	positive	distal	Sex-combined
DAB2	NA	distal	Sex-combined
DAG1	positive	distal	Sex-combined
DAPP1	NA	distal	Sex-combined
DARS1	negative	distal	Sex-combined
DBI	negative	distal	Sex-combined
DBNL	positive	distal	Sex-combined
DCBLD2	negative	distal	Sex-combined
DCTPP1	negative	distal	Sex-combined
DCXR	positive	distal	Sex-combined
DDAH1	negative	distal	Sex-combined
DDC	positive	distal	Sex-combined
DECR1	positive	distal	Sex-combined
DFFA	NA	distal	Sex-combined
DKK1	positive	distal	Sex-combined
DKK3	negative	distal	Sex-combined
DKK4	positive	distal	Sex-combined
DKKL1	negative	distal	Sex-combined
DLK1	negative	distal	Sex-combined
DNAJB1	positive	distal	Sex-combined
DNER	positive	distal	Sex-combined
DNMBP	positive	distal	Sex-combined
DOK2	positive	distal	Sex-combined
DPP4	negative	distal	Sex-combined
DPP7	negative	distal	Sex-combined
DPT	NA	distal	Sex-combined
DPY30	NA	distal	Sex-combined
DRAXIN	negative	distal	Sex-combined
DRG2	negative	distal	Sex-combined
DSG4	negative	distal	Sex-combined
DTX3	positive	distal	Sex-combined
DUSP3	NA	distal	Sex-combined
EBAG9	positive	distal	Sex-combined
ECE1	positive	distal	Sex-combined
EDA2R	negative	distal	Sex-combined
EDAR	positive	distal	Sex-combined
EDIL3	NA	distal	Sex-combined
EFEMP1	negative	distal	Sex-combined
EFNA1	positive	distal	Sex-combined
EGFL7	positive	distal	Sex-combined
EGLN1	negative	distal	Sex-combined
EIF4B	positive	distal	Sex-combined
EIF4G1	positive	distal	Sex-combined
ELOA	NA	distal	Sex-combined
ENG	negative	distal	Sex-combined
ENPP2	negative	distal	Sex-combined
ENPP5	negative	distal	Sex-combined
ENPP7	negative	distal	Sex-combined
ENTPD2	NA	distal	Sex-combined
ENTPD5	negative	distal	Sex-combined
EPHA2	negative	distal	Sex-combined
EPHB4	negative	distal	Sex-combined
EPHB6	positive	distal	Sex-combined
EPS8L2	positive	distal	Sex-combined
ERBB2	negative	distal	Sex-combined
ERBB3	negative	distal	Sex-combined
ERBIN	NA	distal	Sex-combined
ESAM	negative	distal	Sex-combined
F11R	positive	distal	Sex-combined
F2R	negative	distal	Sex-combined
F3	negative	distal	Sex-combined
F7	positive	distal	Sex-combined
F9	NA	distal	Sex-combined
FABP1	NA	distal	Sex-combined
FABP5	NA	distal	Sex-combined
FABP6	NA	distal	Sex-combined
FADD	positive	distal	Sex-combined
FAM3B	positive	distal	Sex-combined
FAP	positive	distal	Sex-combined
FAS	negative	distal	Sex-combined
FASLG	negative	distal	Sex-combined
FBP1	negative	distal	Sex-combined
FCAR	positive	distal	Sex-combined
FCER2	positive	distal	Sex-combined
FCGR3B	negative	distal	Sex-combined
FCRL5	negative	distal	Sex-combined
FCRL6	positive	distal	Sex-combined
FCRLB	negative	distal	Sex-combined
FETUB	positive	distal	Sex-combined
FGF19	negative	distal	Sex-combined
FGF2	negative	distal	Sex-combined
FGF21	negative	distal	Sex-combined
FGF23	positive	distal	Sex-combined
FGF5	NA	distal	Sex-combined
FHIT	NA	distal	Sex-combined
FIS1	positive	distal	Sex-combined
FKBP1B	negative	distal	Sex-combined
FKBP5	negative	distal	Sex-combined
FLI1	positive	distal	Sex-combined
FLRT2	positive	distal	Sex-combined
FLT1	negative	distal	Sex-combined
FLT4	negative	distal	Sex-combined
FOLR1	positive	distal	Sex-combined
FOLR3	positive	distal	Sex-combined
FRZB	NA	distal	Sex-combined
FSTL3	NA	distal	Sex-combined
FUS	NA	distal	Sex-combined
FUT3_FUT5	negative	distal	Sex-combined
FUT8	negative	distal	Sex-combined
FXN	positive	distal	Sex-combined
FXYD5	NA	distal	Sex-combined
FYB1	NA	distal	Sex-combined
GAL	positive	distal	Sex-combined
GALNT2	positive	distal	Sex-combined
GALNT7	positive	distal	Sex-combined
GAS6	negative	distal	Sex-combined
GCNT1	negative	distal	Sex-combined
GFRA1	positive	distal	Sex-combined
GFRA2	negative	distal	Sex-combined
GFRA3	positive	distal	Sex-combined
GGH	negative	distal	Sex-combined
GGT5	negative	distal	Sex-combined
GHRL	negative	distal	Sex-combined
GKN1	negative	distal	Sex-combined
GLOD4	NA	distal	Sex-combined
GLRX	NA	distal	Sex-combined
GNE	positive	distal	Sex-combined
GNLY	positive	distal	Sex-combined
GOLM2	positive	distal	Sex-combined
GOPC	NA	distal	Sex-combined
GPC5	negative	distal	Sex-combined
GPR37	negative	distal	Sex-combined
GRAP2	positive	distal	Sex-combined
GRN	positive	distal	Sex-combined
GRPEL1	positive	distal	Sex-combined
GUSB	negative	distal	Sex-combined
GYS1	negative	distal	Sex-combined
HARS1	NA	distal	Sex-combined
HAVCR2	positive	distal	Sex-combined
HBEGF	negative	distal	Sex-combined
HBQ1	NA	distal	Sex-combined
HCLS1	positive	distal	Sex-combined
HDGF	NA	distal	Sex-combined
HEXIM1	positive	distal	Sex-combined
HGF	positive	distal	Sex-combined
HLA-DRA	positive	distal	Sex-combined
HMOX1	positive	distal	Sex-combined
HMOX2	negative	distal	Sex-combined
HNMT	positive	distal	Sex-combined
HS6ST1	positive	distal	Sex-combined
HSD11B1	negative	distal	Sex-combined
HSPA1A	NA	distal	Sex-combined
HSPB6	positive	distal	Sex-combined
HYAL1	negative	distal	Sex-combined
ICA1	NA	distal	Sex-combined
ICAM2	negative	distal	Sex-combined
ICAM3	negative	distal	Sex-combined
ICAM4	negative	distal	Sex-combined
ICAM5	positive	distal	Sex-combined
ICOSLG	positive	distal	Sex-combined
IDS	negative	distal	Sex-combined
IFNG	NA	distal	Sex-combined
IFNGR1	negative	distal	Sex-combined
IFNGR2	negative	distal	Sex-combined
IFNL1	negative	distal	Sex-combined
IFNLR1	NA	distal	Sex-combined
IGF2R	positive	distal	Sex-combined
IGFBP1	NA	distal	Sex-combined
IGFBP2	positive	distal	Sex-combined
IGFBP3	negative	distal	Sex-combined
IGFBP4	negative	distal	Sex-combined
IGFBP6	negative	distal	Sex-combined
IGFBP7	negative	distal	Sex-combined
IGFBPL1	NA	distal	Sex-combined
IGSF3	positive	distal	Sex-combined
IGSF8	positive	distal	Sex-combined
IL10RB	positive	distal	Sex-combined
IL13RA1	NA	distal	Sex-combined
IL15	positive	distal	Sex-combined
IL17C	NA	distal	Sex-combined
IL17D	NA	distal	Sex-combined
IL17RA	positive	distal	Sex-combined
IL17RB	positive	distal	Sex-combined
IL18	negative	distal	Sex-combined
IL18BP	negative	distal	Sex-combined
IL18R1	negative	distal	Sex-combined
IL1B	NA	distal	Sex-combined
IL1R1	negative	distal	Sex-combined
IL1R2	positive	distal	Sex-combined
IL1RAP	positive	distal	Sex-combined
IL1RN	NA	distal	Sex-combined
IL22RA1	NA	distal	Sex-combined
IL2RA	negative	distal	Sex-combined
IL4R	positive	distal	Sex-combined
IL5RA	negative	distal	Sex-combined
IL6	negative	distal	Sex-combined
IL7	positive	distal	Sex-combined
IL7R	negative	distal	Sex-combined
INHBC	negative	distal	Sex-combined
INPP1	NA	distal	Sex-combined
IPCEF1	NA	distal	Sex-combined
IRAG2	NA	distal	Sex-combined
ISLR2	negative	distal	Sex-combined
ISM1	NA	distal	Sex-combined
ITGA5	negative	distal	Sex-combined
ITGA6	negative	distal	Sex-combined
ITGAV	positive	distal	Sex-combined
ITGB1	negative	distal	Sex-combined
ITGB6	negative	distal	Sex-combined
JCHAIN	positive	distal	Sex-combined
KAZALD1	negative	distal	Sex-combined
KDR	positive	distal	Sex-combined
KEL	negative	distal	Sex-combined
KIFBP	NA	distal	Sex-combined
KIR3DL1	NA	distal	Sex-combined
KIRREL2	negative	distal	Sex-combined
KLB	negative	distal	Sex-combined
KLK1	positive	distal	Sex-combined
KLK11	positive	distal	Sex-combined
KLK12	negative	distal	Sex-combined
KLK13	positive	distal	Sex-combined
KLK14	negative	distal	Sex-combined
KLK6	NA	distal	Sex-combined
KLK8	negative	distal	Sex-combined
KLRB1	negative	distal	Sex-combined
KRT18	negative	distal	Sex-combined
KRT19	negative	distal	Sex-combined
KRT5	negative	distal	Sex-combined
KYNU	positive	distal	Sex-combined
LACTB2	negative	distal	Sex-combined
LAMA4	positive	distal	Sex-combined
LAMP2	NA	distal	Sex-combined
LAT	positive	distal	Sex-combined
LBP	NA	distal	Sex-combined
LEFTY2	negative	distal	Sex-combined
LEPR	negative	distal	Sex-combined
LGALS1	NA	distal	Sex-combined
LGALS3	positive	distal	Sex-combined
LGALS7_LGALS7B	negative	distal	Sex-combined
LGMN	negative	distal	Sex-combined
LILRA5	negative	distal	Sex-combined
LILRB1	positive	distal	Sex-combined
LILRB4	NA	distal	Sex-combined
LILRB5	NA	distal	Sex-combined
LPL	positive	distal	Sex-combined
LPO	positive	distal	Sex-combined
LRIG1	positive	distal	Sex-combined
LRP1	positive	distal	Sex-combined
LRP11	positive	distal	Sex-combined
LRPAP1	positive	distal	Sex-combined
LSP1	NA	distal	Sex-combined
LTA	negative	distal	Sex-combined
LTBP2	negative	distal	Sex-combined
LTBP3	negative	distal	Sex-combined
LY6D	positive	distal	Sex-combined
LY9	negative	distal	Sex-combined
LY96	negative	distal	Sex-combined
LYN	positive	distal	Sex-combined
LYPD8	positive	distal	Sex-combined
MANF	positive	distal	Sex-combined
MANSC1	positive	distal	Sex-combined
MAP2K6	NA	distal	Sex-combined
MAP4K5	NA	distal	Sex-combined
MARCO	negative	distal	Sex-combined
MASP1	positive	distal	Sex-combined
MATN2	negative	distal	Sex-combined
MATN3	negative	distal	Sex-combined
MAVS	positive	distal	Sex-combined
MDGA1	positive	distal	Sex-combined
MEGF10	positive	distal	Sex-combined
MEGF9	positive	distal	Sex-combined
MERTK	negative	distal	Sex-combined
MESD	positive	distal	Sex-combined
MET	negative	distal	Sex-combined
METAP2	positive	distal	Sex-combined
MFAP5	positive	distal	Sex-combined
MFGE8	positive	distal	Sex-combined
MGMT	positive	distal	Sex-combined
MIA	positive	distal	Sex-combined
MIF	negative	distal	Sex-combined
MILR1	positive	distal	Sex-combined
MITD1	NA	distal	Sex-combined
MMP1	negative	distal	Sex-combined
MMP10	NA	distal	Sex-combined
MMP12	NA	distal	Sex-combined
MMP3	negative	distal	Sex-combined
MMP7	negative	distal	Sex-combined
MMP8	NA	distal	Sex-combined
MMP9	positive	distal	Sex-combined
MPHOSPH8	NA	distal	Sex-combined
MPI	negative	distal	Sex-combined
MPO	positive	distal	Sex-combined
MSLN	positive	distal	Sex-combined
MSMB	negative	distal	Sex-combined
MSRA	NA	distal	Sex-combined
MUC13	positive	distal	Sex-combined
MUC16	NA	distal	Sex-combined
MYOC	positive	distal	Sex-combined
MZT1	NA	distal	Sex-combined
NADK	negative	distal	Sex-combined
NBN	positive	distal	Sex-combined
NCAM2	positive	distal	Sex-combined
NCAN	positive	distal	Sex-combined
NCF2	positive	distal	Sex-combined
NCR1	negative	distal	Sex-combined
NCS1	positive	distal	Sex-combined
NEFL	NA	distal	Sex-combined
NELL1	positive	distal	Sex-combined
NFASC	positive	distal	Sex-combined
NFKBIE	NA	distal	Sex-combined
NID1	negative	distal	Sex-combined
NID2	positive	distal	Sex-combined
NME3	negative	distal	Sex-combined
NOMO1	negative	distal	Sex-combined
NOS3	NA	distal	Sex-combined
NOTCH1	negative	distal	Sex-combined
NPDC1	negative	distal	Sex-combined
NPPB	NA	distal	Sex-combined
NPPC	NA	distal	Sex-combined
NPTX1	positive	distal	Sex-combined
NPTXR	negative	distal	Sex-combined
NRP2	positive	distal	Sex-combined
NSFL1C	NA	distal	Sex-combined
NT5C3A	positive	distal	Sex-combined
NTF3	negative	distal	Sex-combined
NUB1	positive	distal	Sex-combined
NUDC	NA	distal	Sex-combined
NUDT2	NA	distal	Sex-combined
NUDT5	NA	distal	Sex-combined
OBP2B	positive	distal	Sex-combined
ODAM	NA	distal	Sex-combined
OGFR	NA	distal	Sex-combined
OMG	positive	distal	Sex-combined
OPTC	negative	distal	Sex-combined
OSMR	positive	distal	Sex-combined
OXT	negative	distal	Sex-combined
PAEP	negative	distal	Sex-combined
PAG1	negative	distal	Sex-combined
PAM	negative	distal	Sex-combined
PAPPA	positive	distal	Sex-combined
PARK7	negative	distal	Sex-combined
PARP1	NA	distal	Sex-combined
PCSK9	negative	distal	Sex-combined
PDCD1	negative	distal	Sex-combined
PDCD5	NA	distal	Sex-combined
PDGFRA	negative	distal	Sex-combined
PDLIM7	negative	distal	Sex-combined
PEBP1	NA	distal	Sex-combined
PFKFB2	positive	distal	Sex-combined
PGF	NA	distal	Sex-combined
PGLYRP1	positive	distal	Sex-combined
PI3	positive	distal	Sex-combined
PIGR	positive	distal	Sex-combined
PIK3IP1	negative	distal	Sex-combined
PILRA	positive	distal	Sex-combined
PKLR	positive	distal	Sex-combined
PLA2G10	negative	distal	Sex-combined
PLA2G15	negative	distal	Sex-combined
PLA2G1B	positive	distal	Sex-combined
PLA2G2A	negative	distal	Sex-combined
PLA2G4A	NA	distal	Sex-combined
PLAU	positive	distal	Sex-combined
PLIN3	NA	distal	Sex-combined
PLPBP	NA	distal	Sex-combined
PLXDC1	positive	distal	Sex-combined
PLXNA4	positive	distal	Sex-combined
PLXNB2	positive	distal	Sex-combined
PLXNB3	negative	distal	Sex-combined
PM20D1	positive	distal	Sex-combined
PMVK	negative	distal	Sex-combined
PNPT1	NA	distal	Sex-combined
PODXL	negative	distal	Sex-combined
PODXL2	positive	distal	Sex-combined
PON2	negative	distal	Sex-combined
PPCDC	NA	distal	Sex-combined
PPP1R2	positive	distal	Sex-combined
PPP1R9B	NA	distal	Sex-combined
PPY	negative	distal	Sex-combined
PRCP	negative	distal	Sex-combined
PRDX1	NA	distal	Sex-combined
PRDX5	NA	distal	Sex-combined
PRL	negative	distal	Sex-combined
PROC	negative	distal	Sex-combined
PROK1	NA	distal	Sex-combined
PRSS2	positive	distal	Sex-combined
PRSS27	positive	distal	Sex-combined
PRSS8	positive	distal	Sex-combined
PRTFDC1	negative	distal	Sex-combined
PRTG	positive	distal	Sex-combined
PRTN3	positive	distal	Sex-combined
PSME1	NA	distal	Sex-combined
PSRC1	NA	distal	Sex-combined
PTGDS	NA	distal	Sex-combined
PTPN1	NA	distal	Sex-combined
PTPN6	NA	distal	Sex-combined
PTPRM	negative	distal	Sex-combined
PTPRS	positive	distal	Sex-combined
PTX3	positive	distal	Sex-combined
PVR	NA	distal	Sex-combined
RAB6A	NA	distal	Sex-combined
RABGAP1L	NA	distal	Sex-combined
RAD23B	NA	distal	Sex-combined
RBP5	negative	distal	Sex-combined
REG1A	negative	distal	Sex-combined
REG1B	negative	distal	Sex-combined
REG3A	negative	distal	Sex-combined
REG4	NA	distal	Sex-combined
RELT	positive	distal	Sex-combined
REN	NA	distal	Sex-combined
RGMA	positive	distal	Sex-combined
RGMB	positive	distal	Sex-combined
RILP	positive	distal	Sex-combined
RNASE3	positive	distal	Sex-combined
ROBO1	positive	distal	Sex-combined
ROBO2	negative	distal	Sex-combined
ROR1	positive	distal	Sex-combined
RP2	NA	distal	Sex-combined
RSPO3	positive	distal	Sex-combined
RTBDN	NA	distal	Sex-combined
RWDD1	NA	distal	Sex-combined
S100A11	NA	distal	Sex-combined
S100A4	negative	distal	Sex-combined
SAMD9L	NA	distal	Sex-combined
SCAMP3	positive	distal	Sex-combined
SCARB2	positive	distal	Sex-combined
SCARF2	negative	distal	Sex-combined
SCG2	negative	distal	Sex-combined
SCG3	positive	distal	Sex-combined
SCGB1A1	negative	distal	Sex-combined
SCRN1	NA	distal	Sex-combined
SDC1	negative	distal	Sex-combined
SELE	negative	distal	Sex-combined
SELPLG	positive	distal	Sex-combined
SEMA4C	negative	distal	Sex-combined
SEPTIN9	NA	distal	Sex-combined
SERPINA11	positive	distal	Sex-combined
SERPINA12	positive	distal	Sex-combined
SERPINB1	positive	distal	Sex-combined
SERPINB8	NA	distal	Sex-combined
SERPINB9	NA	distal	Sex-combined
SETMAR	NA	distal	Sex-combined
SEZ6L	positive	distal	Sex-combined
SEZ6L2	negative	distal	Sex-combined
SFTPA2	negative	distal	Sex-combined
SFTPD	positive	distal	Sex-combined
SH2D1A	NA	distal	Sex-combined
SHMT1	positive	distal	Sex-combined
SIGLEC10	negative	distal	Sex-combined
SIGLEC5	positive	distal	Sex-combined
SIGLEC6	negative	distal	Sex-combined
SIGLEC7	negative	distal	Sex-combined
SIRPA	positive	distal	Sex-combined
SIRPB1	negative	distal	Sex-combined
SIRT2	NA	distal	Sex-combined
SIT1	negative	distal	Sex-combined
SKAP2	positive	distal	Sex-combined
SLAMF1	negative	distal	Sex-combined
SLAMF7	negative	distal	Sex-combined
SLC16A1	positive	distal	Sex-combined
SLC39A14	NA	distal	Sex-combined
SLC39A5	negative	distal	Sex-combined
SMOC1	positive	distal	Sex-combined
SMOC2	positive	distal	Sex-combined
SMPDL3A	negative	distal	Sex-combined
SNAP23	NA	distal	Sex-combined
SNAP29	positive	distal	Sex-combined
SNX9	NA	distal	Sex-combined
SOD2	positive	distal	Sex-combined
SORCS2	negative	distal	Sex-combined
SOST	positive	distal	Sex-combined
SPARCL1	positive	distal	Sex-combined
SPINK4	negative	distal	Sex-combined
SPINT1	positive	distal	Sex-combined
SPRY2	positive	distal	Sex-combined
SRP14	NA	distal	Sex-combined
SRPK2	positive	distal	Sex-combined
SSC5D	positive	distal	Sex-combined
ST3GAL1	negative	distal	Sex-combined
STAMBP	positive	distal	Sex-combined
STAT5B	NA	distal	Sex-combined
STIP1	NA	distal	Sex-combined
STK11	positive	distal	Sex-combined
STK24	NA	distal	Sex-combined
STK4	positive	distal	Sex-combined
STX4	NA	distal	Sex-combined
STX8	NA	distal	Sex-combined
SULT2A1	positive	distal	Sex-combined
SUMF2	positive	distal	Sex-combined
SUSD1	negative	distal	Sex-combined
SUSD2	positive	distal	Sex-combined
TAFA5	NA	distal	Sex-combined
TARBP2	NA	distal	Sex-combined
TBC1D23	positive	distal	Sex-combined
TBC1D5	NA	distal	Sex-combined
TBCB	positive	distal	Sex-combined
TBCC	negative	distal	Sex-combined
TBL1X	negative	distal	Sex-combined
TCL1A	positive	distal	Sex-combined
TDGF1	NA	distal	Sex-combined
TDRKH	positive	distal	Sex-combined
TFF1	negative	distal	Sex-combined
TFF2	negative	distal	Sex-combined
TFF3	negative	distal	Sex-combined
TFPI	positive	distal	Sex-combined
TFPI2	negative	distal	Sex-combined
TFRC	positive	distal	Sex-combined
TGFBI	negative	distal	Sex-combined
TGFBR3	negative	distal	Sex-combined
TGM2	NA	distal	Sex-combined
THBS2	positive	distal	Sex-combined
THY1	negative	distal	Sex-combined
TIA1	NA	distal	Sex-combined
TIE1	negative	distal	Sex-combined
TIGAR	NA	distal	Sex-combined
TIMP1	positive	distal	Sex-combined
TINAGL1	positive	distal	Sex-combined
TLR3	negative	distal	Sex-combined
TMPRSS15	negative	distal	Sex-combined
TMPRSS5	positive	distal	Sex-combined
TNC	positive	distal	Sex-combined
TNFRSF10A	negative	distal	Sex-combined
TNFRSF10C	negative	distal	Sex-combined
TNFRSF11A	negative	distal	Sex-combined
TNFRSF12A	NA	distal	Sex-combined
TNFRSF13B	positive	distal	Sex-combined
TNFRSF13C	positive	distal	Sex-combined
TNFRSF14	positive	distal	Sex-combined
TNFRSF19	negative	distal	Sex-combined
TNFRSF1A	negative	distal	Sex-combined
TNFRSF1B	negative	distal	Sex-combined
TNFRSF21	negative	distal	Sex-combined
TNFRSF4	negative	distal	Sex-combined
TNFRSF6B	positive	distal	Sex-combined
TNFRSF8	negative	distal	Sex-combined
TNFSF10	negative	distal	Sex-combined
TNFSF12	positive	distal	Sex-combined
TNR	negative	distal	Sex-combined
TNXB	positive	distal	Sex-combined
TPMT	NA	distal	Sex-combined
TPSAB1	negative	distal	Sex-combined
TREM2	positive	distal	Sex-combined
TREML2	negative	distal	Sex-combined
TRIAP1	negative	distal	Sex-combined
TRIM21	negative	distal	Sex-combined
TSHB	positive	distal	Sex-combined
TXLNA	NA	distal	Sex-combined
TXNDC15	positive	distal	Sex-combined
TXNDC5	negative	distal	Sex-combined
TYMP	NA	distal	Sex-combined
UMOD	negative	distal	Sex-combined
USO1	positive	distal	Sex-combined
USP8	negative	distal	Sex-combined
UXS1	negative	distal	Sex-combined
VCAM1	negative	distal	Sex-combined
VEGFA	positive	distal	Sex-combined
VEGFC	negative	distal	Sex-combined
VNN2	positive	distal	Sex-combined
VPS37A	NA	distal	Sex-combined
VSIG4	positive	distal	Sex-combined
VSIR	negative	distal	Sex-combined
VSTM1	NA	distal	Sex-combined
VSTM2L	NA	distal	Sex-combined
VWA1	negative	distal	Sex-combined
VWC2	NA	distal	Sex-combined
VWF	positive	distal	Sex-combined
WAS	NA	distal	Sex-combined
WASF1	NA	distal	Sex-combined
WFDC12	positive	distal	Sex-combined
WFDC2	positive	distal	Sex-combined
WFIKKN2	negative	distal	Sex-combined
WWP2	NA	distal	Sex-combined
XPNPEP2	positive	distal	Sex-combined
YES1	NA	distal	Sex-combined
ZBTB16	positive	distal	Sex-combined
ZBTB17	NA	distal	Sex-combined
